# Esperanto-French translations created from the Universal dictionary at 2011-05-28T05:47:00-06:00
# (c) Copyright 2011 by All free dictionaries project
# ALL FREE DICTIONARIES PROJECT DISCLAIMS ALL
# WARRANTIES WITH REGARD TO THESE TRANSLATIONS, INCLUDING ALL
# IMPLIED WARRANTIES OF MERCHANTABILITY AND FITNESS. IN NO
# EVENT SHALL ALL FREE DICTIONARIES PROJECT OR ANY OF ITS CONTRIBUTORS
# BE LIABLE FOR ANY SPECIAL, INDIRECT OR CONSEQUENTIAL DAMAGES
# OR ANY DAMAGES WHATSOEVER RESULTING FROM LOSS OF USE, DATA OR
# PROFITS, WHETHER IN AN ACTION OF CONTRACT, NEGLIGENCE
# OR OTHER ACTION, ARISING OUT OF OR IN CONNECTION
# WITH THE USE OR PERFORMANCE OF THESE TRANSLATIONS.
#
# In other words there may be incorrect translations.
# If you need to be sure never use these translations!
#
# French, German and Czech entries are added manually. The entries for
# remaining languages are added automatically. Entries for these languages
# are only experimental.
#
# You may not place this file on WWW, ftp and equivalent servers because
# this file gets outdated very quickly. You may not distribute this file
# with your dictionary applications without permission. You can contact
# authors of the Universal dictionary at: http://dicts.info/contact.php
#
# This file is for personal use only. You may not distribute this file.
#
# New version of this file can be created at: http://www.dicts.info/uddl.php
#

 Angla lingvo 	 anglais 	 language 
 Britio 	 Britain 	 country 
 Francio 	 République française 	 country 
 Germana lingvo 	 allemand 	 linguistics 
 Germanio 	 République fédérale d'Allemagne 	 country 
 Hindio 	 République de l'Inde 	 country 
 Hispanujo 	 Royaume d'Espagne 	 country 
 Italio 	 Italie 	 country 
 Japanio 	 Japon 	 country 
 Tero 	 Terre 	 nature 
 Usono 	 États-Unis 	 country 
 abelo 	 abeille 	 animal 
 abrupta 	 escarpé 	 adjective 
 acido 	 acide 	 material 
 adicio 	 addition 	 mathematics 
 adjektivo 	 adjectif 	 linguistics 
 administri 	 administrer 	 verb 
 adreso 	 adresse 	 abstract 
 aero 	 air 	 nature 
 aerodromo 	 aérodrome 	 city 
 aeroplano 	 avion 	 object 
 afabla 	 gentil 	 adjective 
 afranko 	 port 	 object 
 agi 	 agir 	 verb 
 ago 	 acte 	 abstract 
 ago 	 action 	 mathematics 
 ago 	 activité 	 mathematics 
 ajna 	 facultatif 	 adjective 
 ajxo 	 chose 	 object 
 akcepti 	 accepter 	 verb 
 akcidento 	 accident 	 transport 
 akcio 	 action 	 business 
 akiri 	 attraper 	 verb 
 akiri 	 obtenir 	 verb 
 akra 	 aiguisé 	 adjective 
 aktorino 	 actrice 	 profession 
 aktoro 	 comédien 	 profession 
 akuzi 	 accuser 	 verb 
 akuzo 	 accusation 	 society 
 akvo 	 eau 	 material 
 al 	 contre 	 preposition 
 al 	 vers 	 preposition 
 aldoni 	 additionner 	 verb 
 aldono 	 composant additionnel 	 abstract 
 alia 	 autre 	 adjective 
 alia 	 autre 	 adjective 
 alporti 	 apporter 	 verb 
 alta 	 grand 	 adjective 
 alteco 	 hauteur 	 abstract 
 alternativo 	 alternative 	 abstract 
 alumeto 	 allumette 	 object 
 alveni 	 arriver 	 verb 
 alvoki 	 téléphoner 	 verb 
 amara 	 amer 	 adjective 
 ambaux 	 l'un et l'autre 	 adjective 
 ami 	 aimer 	 verb 
 amika 	 amical 	 adjective 
 amiko 	 copain 	 family 
 amisto 	 amant 	 family 
 amo 	 passion 	 relations 
 amplekso 	 zone 	 abstract 
 angulo 	 angle 	 mathematics 
 animala 	 animal 	 nature 
 ankaŭ 	 aussi 	 adverb 
 ankoraux 	 encore 	 adverb 
 anonci 	 annoncer 	 verb 
 anso 	 oreille 	 object 
 antaux 	 avant 	 adverb 
 antaux 	 devant 	 adverb 
 antauxa 	 premier 	 adjective 
 antauxajxo 	 avant 	 abstract 
 antauxcxambro 	 entrée 	 house 
 antauxen 	 avant 	 adverb 
 aparato 	 machine 	 device 
 aparta 	 séparée 	 adjective 
 apartamento 	 appartement 	 society 
 apogo 	 appui 	 abstract 
 aprilo 	 avril 	 time 
 aprobo 	 approbation 	 communication 
 apuda 	 adjacent 	 adjective 
 arbaro 	 forêt 	 nature 
 arbo 	 arbre 	 house 
 argumenti 	 plaider 	 verb 
 argumento 	 argument 	 communication 
 armeo 	 armée 	 society 
 armeo 	 armée 	 society 
 artisto 	 artiste 	 profession 
 arto 	 art 	 art 
 arĝento 	 argent 	 material 
 ascendo 	 ascension 	 abstract 
 asekuro 	 assurance 	 business 
 aserto 	 déclaration 	 communication 
 aspekti 	 paraître 	 verb 
 aspekto 	 aspect 	 abstract 
 astro 	 étoile 	 nature 
 ataki 	 attaquer 	 verb 
 atako 	 attaque 	 abstract 
 atendi 	 attendre 	 verb 
 atenti 	 attention 	 verb 
 atento 	 attention 	 communication 
 atingi 	 réaliser 	 verb 
 atributo 	 caractéristique 	 abstract 
 auxdi 	 entendre 	 verb 
 avantagxo 	 avantage 	 abstract 
 aĉeti 	 acheter 	 verb 
 aĝo 	 âge 	 time 
 aĵo 	 occupation 	 abstract 
 aŭ 	 ou 	 conjunction 
 aŭdi 	 ausculter 	 verb 
 aŭstrala 	 austral 	 adjective 
 aŭtobuso 	 autocar 	 transport 
 aŭtomata 	 automatique 	 adjective 
 aŭtomobilo 	 automobile 	 transport 
 aŭtoritato 	 autorité 	 society 
 aŭtuno 	 automne 	 nature 
 bagatela 	 petit 	 adjective 
 baldaux 	 bientôt 	 adverb 
 bancxambro 	 salle de bains 	 house 
 banko 	 banque 	 city 
 bano 	 bain 	 house 
 barbara 	 barbare 	 adjective 
 basbalo 	 base-ball 	 sports 
 bastono 	 bâton 	 object 
 bastono 	 personnel 	 society 
 batalado 	 lutte 	 abstract 
 batali 	 lutter 	 verb 
 bato 	 coup 	 abstract 
 baza 	 fondamental 	 adjective 
 bazaro 	 marché 	 business 
 bazo 	 base 	 mathematics 
 bazo 	 base 	 society 
 beko 	 bec 	 anatomy 
 bela 	 beau 	 adjective 
 beleta 	 gentil 	 adjective 
 bezono 	 besoin 	 abstract 
 biblioteko 	 bibliothèque 	 city 
 biciklo 	 bicyclette 	 object 
 biero 	 bière 	 food 
 bildo 	 image 	 art 
 bildo 	 image 	 art 
 bileto 	 billet 	 object 
 biologio 	 biologie 	 science 
 birdo 	 oiseau 	 animal 
 blanka 	 blanc 	 adjective 
 blua 	 bleu 	 color 
 boato 	 bateau 	 object 
 bobeni 	 enrouler 	 verb 
 bobeno 	 rouleau 	 object 
 boltingo 	 écrou 	 object 
 bona 	 bon 	 adjective 
 bona 	 bon 	 adjective 
 bone 	 bien 	 adverb 
 bonega 	 excellent 	 adjective 
 bonŝanca 	 chanceux 	 adjective 
 bordo 	 rive 	 nature 
 botelo 	 bouteille 	 food 
 boto 	 botte 	 clothes 
 bovino 	 vache 	 animal 
 brako 	 bras 	 anatomy 
 brancxo 	 branche 	 nature 
 bretaro 	 clayette 	 house 
 briko 	 brique 	 house 
 broso 	 brosse 	 object 
 bruna 	 marron 	 color 
 bruo 	 bruit 	 society 
 bruska 	 brusque 	 adjective 
 brusto 	 poitrine 	 anatomy 
 brusto 	 poitrine 	 anatomy 
 butero 	 beurre 	 food 
 butono 	 bouton 	 object 
 buŝo 	 bouche 	 anatomy 
 celo 	 destination 	 abstract 
 cent 	 cent 	 number 
 centra 	 central 	 adjective 
 centro 	 centre 	 mathematics 
 centro 	 milieu 	 mathematics 
 cerbo 	 cerveau 	 anatomy 
 certa 	 certain 	 adjective 
 certe 	 assurément 	 adverb 
 cirkla 	 rond 	 adjective 
 cxar 	 car 	 conjunction 
 cxefo 	 chef 	 society 
 cxeko 	 chèque 	 business 
 cxelo 	 cellule 	 society 
 cxevalo 	 cheval 	 animal 
 cxielo 	 ciel 	 nature 
 cxio 	 tout 	 adjective 
 cxio 	 tout 	 pronoun 
 cxirkaux 	 autour 	 adverb 
 cxirkauxajxo 	 alentours 	 nature 
 cxiu 	 chacun 	 adjective 
 cxiu 	 chacun 	 adjective 
 cxu 	 si 	 conjunction 
 damagxi 	 blesser 	 verb 
 damagxo 	 sinistre 	 transport 
 danci 	 danser 	 verb 
 danki 	 remercier 	 verb 
 danĝera 	 dangereux 	 adjective 
 danĝero 	 danger 	 abstract 
 dato 	 date 	 time 
 datumoj 	 données 	 communication 
 dauxrigi 	 continuer 	 verb 
 de 	 de 	 preposition 
 decembro 	 décembre 	 time 
 decidi 	 décider 	 verb 
 decido 	 décision 	 communication 
 defendo 	 défense 	 abstract 
 defii 	 affronter 	 verb 
 dek 	 dix 	 number 
 dekdua 	 douzième 	 number 
 deklivo 	 pente 	 mathematics 
 dekoro 	 ornement 	 object 
 dekstra 	 droit 	 adjective 
 delikata 	 délicat 	 adjective 
 demando 	 question 	 linguistics 
 dento 	 dent 	 anatomy 
 depago 	 prix 	 business 
 desegni 	 dessiner 	 verb 
 desegno 	 modèle 	 object 
 detalo 	 détail 	 logistics 
 detruo 	 destruction 	 abstract 
 devio 	 écart 	 mathematics 
 devo 	 devoir 	 abstract 
 deziri 	 désirer 	 verb 
 deziro 	 souhait 	 abstract 
 difekti 	 endommager 	 verb 
 diferenca 	 différent 	 adjective 
 diferenco 	 différence 	 abstract 
 dika 	 gros 	 adjective 
 dika 	 épais 	 adjective 
 dikfingro 	 pouce 	 anatomy 
 dimancxo 	 dimanche 	 time 
 direkto 	 direction 	 mathematics 
 direktoro 	 directeur 	 profession 
 diri 	 dire 	 verb 
 disciplino 	 discipline 	 linguistics 
 diskuti 	 discuter 	 verb 
 diskuto 	 argument 	 communication 
 dispremi 	 écraser 	 verb 
 disputi 	 se disputer 	 verb 
 disputo 	 discussion 	 mathematics 
 distanco 	 distance 	 mathematics 
 distraĵo 	 divertissement 	 art 
 diversa 	 divers 	 adjective 
 diverseco 	 diversité 	 art 
 divido 	 partage 	 mathematics 
 divizio 	 secteur 	 mathematics 
 do 	 donc 	 adverb 
 doktoro 	 docteur 	 profession 
 dolcxa 	 sucré 	 adjective 
 doloro 	 douleur 	 medicine 
 dolĉeco 	 douceur 	 food 
 domo 	 immeuble 	 city 
 domo 	 maison 	 house 
 domo 	 maison 	 house 
 donaco 	 présent 	 object 
 doni 	 donner 	 verb 
 dormado 	 sommeil 	 nature 
 dormcxambro 	 chambre à coucher 	 house 
 dorso 	 dos 	 anatomy 
 drato 	 fil 	 object 
 dua 	 deuxième 	 adjective 
 dubi 	 douter 	 verb 
 dubo 	 doute 	 communication 
 dudek 	 vingt 	 number 
 dum 	 pendant 	 preposition 
 duono 	 moitié 	 mathematics 
 duŝo 	 douche 	 house 
 ebena 	 égal 	 adjective 
 ebenejo 	 plaine 	 nature 
 eble 	 peut-être 	 adverb 
 ecx 	 voire 	 adverb 
 edukado 	 éducation 	 society 
 eduki 	 élever 	 verb 
 edzeco 	 mariage 	 society 
 edzigxi 	 épouser 	 verb 
 edzinigxinta 	 marié 	 adjective 
 edzino 	 femme 	 family 
 edzo 	 mari 	 family 
 efektiva 	 vrai 	 adjective 
 egala 	 égal 	 adjective 
 ekde 	 depuis 	 preposition 
 eklezio 	 église 	 city 
 ekonomia 	 économe 	 adjective 
 ekonomia 	 économique 	 adjective 
 ekonomio 	 économie 	 business 
 ekspliki 	 expliquer 	 verb 
 eksplodo 	 salve 	 abstract 
 ekster 	 dehors 	 adverb 
 eksterajxo 	 extérieur 	 mathematics 
 eksterlanda 	 étranger 	 adjective 
 ekvilibro 	 équilibre 	 physics 
 ekzameno 	 examen 	 communication 
 ekzemplo 	 exemple 	 communication 
 ekzerci 	 exercer 	 verb 
 ekzistado 	 existence 	 society 
 ekzisti 	 exister 	 verb 
 elcento 	 pourcentage 	 mathematics 
 elefanto 	 éléphant 	 animal 
 eleganta 	 élégant 	 adjective 
 elekti 	 choisir 	 verb 
 elekto 	 triage 	 abstract 
 elekto 	 élection 	 mathematics 
 elektra 	 électrique 	 adjective 
 elemento 	 élément 	 mathematics 
 elpreni 	 supprimer 	 verb 
 elŝeligi 	 peler 	 verb 
 emigi 	 pousser 	 verb 
 en 	 dans 	 adverb 
 en 	 dans 	 preposition 
 ene 	 à 	 adverb 
 energio 	 énergie 	 nature 
 enhavi 	 rétention 	 verb 
 eniri 	 entrer 	 verb 
 enspezo 	 revenu 	 business 
 envolvi 	 envelopper 	 verb 
 epoko 	 période 	 time 
 epoko 	 âge 	 time 
 erara 	 faux 	 adjective 
 eraro 	 erreur 	 communication 
 esenco 	 essence 	 abstract 
 esperi 	 espérer 	 verb 
 esplorado 	 investigation 	 abstract 
 esploro 	 recherche 	 abstract 
 esprimi 	 formuler 	 verb 
 estinta 	 ancien 	 adjective 
 estonteco 	 futur 	 time 
 estro 	 chef 	 society 
 eta 	 minuscule 	 adjective 
 eta 	 modeste 	 adjective 
 etagxo 	 étage 	 house 
 evento 	 événement 	 abstract 
 eventuala 	 possible 	 adjective 
 evidente 	 manifestement 	 adverb 
 eviti 	 éviter 	 verb 
 evolucii 	 développer 	 verb 
 evoluo 	 évolution 	 nature 
 eĝo 	 bord 	 mathematics 
 fabriki 	 produire 	 verb 
 fabriko 	 usine 	 city 
 fabriko 	 usine 	 city 
 facila 	 facile 	 adjective 
 fakto 	 fait 	 abstract 
 fakturo 	 facture 	 business 
 fali 	 tomber 	 verb 
 falo 	 chute 	 abstract 
 falsa 	 faux 	 adjective 
 falto 	 pli 	 object 
 familio 	 famille 	 family 
 familio 	 famille 	 family 
 farbo 	 peinture 	 art 
 fari 	 faire 	 verb 
 fari 	 rendre 	 verb 
 farmbieno 	 ferme 	 nature 
 faro 	 action 	 mathematics 
 fazo 	 étape 	 time 
 februaro 	 février 	 time 
 feliĉa 	 heureux 	 adjective 
 fendeto 	 fissure 	 abstract 
 fendi 	 diviser 	 verb 
 fenestro 	 fenêtre 	 house 
 fermi 	 clore 	 verb 
 fermita 	 fermé 	 adjective 
 fero 	 fer 	 material 
 festo 	 partie 	 society 
 fetori 	 sentir 	 verb 
 fido 	 foi 	 society 
 fiksita 	 déterminé 	 adjective 
 filino 	 fille 	 family 
 filmo 	 pellicule 	 art 
 filo 	 fils 	 family 
 fina 	 définitif 	 adjective 
 financa 	 financier 	 adjective 
 fingro 	 doigt 	 anatomy 
 fini 	 terminer 	 verb 
 fini 	 terminer 	 verb 
 fino 	 fin 	 abstract 
 firma 	 ferme 	 adjective 
 firmo 	 maison 	 business 
 fizika 	 physique 	 adjective 
 fizika 	 physique 	 adjective 
 fiŝo 	 poisson 	 animal 
 flago 	 drapeau 	 object 
 flamo 	 flamme 	 nature 
 flava 	 jaune 	 color 
 flegado 	 souci 	 abstract 
 flegistino 	 infirmière 	 profession 
 floro 	 fleur 	 nature 
 flugi 	 voler 	 verb 
 flugilo 	 aile 	 anatomy 
 flugo 	 vol 	 transport 
 fluo 	 courant 	 nature 
 fluo 	 courant 	 nature 
 fluo 	 courant 	 nature 
 fojfoje 	 parfois 	 adverb 
 folio 	 feuille 	 nature 
 fondi 	 établir 	 verb 
 fonto 	 source 	 nature 
 fora 	 loin 	 adjective 
 forgesi 	 oublier 	 verb 
 foriri 	 laisser 	 verb 
 forko 	 fourchette 	 food 
 formiko 	 fourmi 	 animal 
 formo 	 forme 	 art 
 formularo 	 questionnaire 	 society 
 forpermeso 	 congé 	 society 
 forto 	 force 	 abstract 
 forto 	 force 	 abstract 
 fotoaparato 	 caméra 	 object 
 fotografisto 	 photographe 	 profession 
 fragila 	 fragile 	 adjective 
 framo 	 cadre 	 object 
 frapo 	 coup 	 abstract 
 fratino 	 soeur 	 family 
 frato 	 frère 	 family 
 frauxlino 	 mademoiselle 	 family 
 frazo 	 phrase 	 linguistics 
 fresxa 	 frais 	 adjective 
 fresxdata 	 récent 	 adjective 
 fromaĝo 	 fromage 	 food 
 frue 	 prématuré 	 adjective 
 frue 	 tôt 	 adverb 
 frukto 	 fruit 	 food 
 frunto 	 front 	 anatomy 
 fumi 	 fumer 	 verb 
 fumo 	 fumée 	 nature 
 funkciado 	 fonctionnement 	 mathematics 
 funkcio 	 fonction 	 linguistics 
 funkcio 	 fonction 	 mathematics 
 gajni 	 arriver 	 verb 
 gajni 	 gagner 	 verb 
 garaĝo 	 dépôt 	 transport 
 gardo 	 sentinelle 	 profession 
 gasto 	 hôte 	 travelling 
 geedzigxo 	 mariage 	 family 
 generalo 	 général 	 profession 
 geno 	 gène 	 anatomy 
 genuo 	 genou 	 anatomy 
 gildo 	 club 	 society 
 gitaro 	 guitare 	 object 
 glacio 	 glace 	 material 
 glacio 	 glace 	 nature 
 glaso 	 verre 	 food 
 glata 	 lissé 	 adjective 
 glito 	 dérapage 	 abstract 
 glueca 	 collant 	 adjective 
 glui 	 coller 	 verb 
 gluo 	 colle 	 material 
 golfo 	 golf 	 travelling 
 golo 	 but 	 sports 
 gorgxo 	 gorge 	 anatomy 
 grado 	 degré 	 linguistics 
 grado 	 niveau 	 linguistics 
 granda 	 grand 	 adjective 
 granda 	 grand 	 adjective 
 grandeco 	 taille 	 physics 
 grasa 	 gros 	 adjective 
 graso 	 gras 	 material 
 grava 	 important 	 adjective 
 grizo 	 gris 	 adjective 
 grizo 	 gris 	 color 
 grundo 	 terre 	 material 
 grundo 	 terre 	 nature 
 grupo 	 compagnie 	 society 
 grupo 	 groupe 	 abstract 
 gusto 	 goût 	 nature 
 gustumi 	 goût 	 verb 
 guto 	 goutte 	 object 
 gxenerala 	 général 	 adjective 
 gxia 	 sa 	 pronoun 
 gxin 	 ça 	 pronoun 
 gxis 	 jusqu'à 	 conjunction 
 gxusta 	 correct 	 adjective 
 gxuste 	 exactement 	 adverb 
 haltigi 	 arrêter 	 verb 
 halto 	 arrêt 	 abstract 
 haro 	 cheveux 	 anatomy 
 haroj 	 cheveux 	 anatomy 
 hauxto 	 peau 	 anatomy 
 havebla 	 disponible 	 adjective 
 havi 	 avoir 	 verb 
 havi 	 avoir 	 verb 
 havo 	 propriété 	 society 
 hejmo 	 foyer 	 house 
 hela 	 clair 	 adjective 
 hela 	 clair 	 adjective 
 helpi 	 soulager 	 verb 
 helpo 	 aide 	 communication 
 herbo 	 herbe 	 nature 
 historio 	 histoire 	 society 
 hodiaŭ 	 aujourd'hui 	 adverb 
 homa 	 humain 	 adjective 
 homo 	 homme 	 family 
 homo 	 homme 	 family 
 honori 	 honorer 	 verb 
 horlogxo 	 horloge 	 device 
 horloĝo 	 montre 	 object 
 horo 	 heure 	 time 
 hotelo 	 hôtel 	 city 
 humideco 	 humidité 	 nature 
 humoro 	 humour 	 communication 
 hundo 	 chien 	 animal 
 iam 	 autrefois 	 adverb 
 identigi 	 identifier 	 verb 
 ili 	 ils 	 pronoun 
 ilia 	 leur 	 pronoun 
 ilin 	 les 	 pronoun 
 imiti 	 imiter 	 verb 
 impostigo 	 contribution 	 business 
 ina 	 féminin 	 adjective 
 indiki 	 indiquer 	 verb 
 individua 	 individuel 	 adjective 
 individuo 	 individu 	 society 
 industria 	 industriel 	 adjective 
 industrio 	 industrie 	 society 
 infaneto 	 bébé 	 family 
 infano 	 enfant 	 family 
 informo 	 information 	 communication 
 inkluzivi 	 comprendre 	 verb 
 inko 	 encre 	 material 
 insekto 	 insecte 	 animal 
 institucio 	 institution 	 society 
 instruado 	 enseignement 	 education 
 instrui 	 enseigner 	 verb 
 instruisto 	 maître 	 profession 
 instrumento 	 instrument 	 device 
 insulo 	 île 	 nature 
 inteligenta 	 habile 	 adjective 
 intenci 	 entendre 	 verb 
 inter 	 entre 	 preposition 
 interesa 	 intéressant 	 adjective 
 intereso 	 intérêt 	 communication 
 interezo 	 intérêt 	 business 
 interkonsento 	 arrangement 	 business 
 internacia 	 international 	 adjective 
 interreto 	 internet 	 mathematics 
 intervjuo 	 interview 	 communication 
 inĝenierarto 	 technologie 	 abstract 
 iri 	 aller 	 verb 
 iĝi 	 devenir 	 verb 
 jako 	 veste 	 clothes 
 jam 	 déjà 	 adverb 
 januaro 	 janvier 	 time 
 jarcento 	 siècle 	 time 
 jaro 	 année 	 time 
 jes 	 oui 	 abstract 
 julio 	 juillet 	 time 
 juna 	 jeune 	 adjective 
 junio 	 juin 	 time 
 jupo 	 jupe 	 clothes 
 juro 	 droit 	 society 
 juvelo 	 bijou 	 object 
 juĝisto 	 juge 	 profession 
 jxauxdo 	 jeudi 	 time 
 jxeti 	 jeter 	 verb 
 kafo 	 café 	 food 
 kaj 	 et 	 conjunction 
 kalkuli 	 compter 	 verb 
 kalkulilo 	 calculateur 	 device 
 kalkulo 	 compte 	 business 
 kampo 	 terrain 	 nature 
 kantisto 	 chanteur 	 profession 
 kanzono 	 chanson 	 art 
 kapabla 	 capable 	 adjective 
 kapitalo 	 capital 	 business 
 kapitulaci 	 abdiquer 	 verb 
 kapo 	 tête 	 anatomy 
 kapro 	 chèvre 	 animal 
 kapti 	 prendre 	 verb 
 karaktero 	 caractère 	 abstract 
 karaktro 	 caractère 	 linguistics 
 karbo 	 charbon 	 material 
 karbonhidrato 	 sucre 	 food 
 kardinala 	 central 	 adjective 
 karto 	 carte 	 object 
 kastelo 	 château 	 city 
 kato 	 chat 	 animal 
 kauxzo 	 cause 	 abstract 
 kemia 	 chimique 	 adjective 
 kemia elemento 	 élément chimique 	 material 
 kemiaĵo 	 chimique 	 material 
 kemio 	 chimie 	 science 
 kesteto 	 cageot 	 object 
 kesto 	 coffre 	 object 
 kial 	 pourquoi 	 adverb 
 kiel 	 comme 	 adverb 
 kies 	 de qui 	 pronoun 
 kiki 	 coup de pied 	 verb 
 kino 	 cinéma 	 city 
 kio 	 quoi 	 pronoun 
 kisi 	 baiser 	 verb 
 kiso 	 baiser 	 relations 
 kiu 	 que 	 pronoun 
 kiu 	 quel 	 pronoun 
 kiu 	 qui 	 pronoun 
 klabo 	 massue 	 object 
 klasi 	 classer 	 verb 
 klaso 	 classe 	 art 
 klavo 	 touche 	 object 
 kliento 	 commettant 	 business 
 klingo 	 voilure 	 object 
 knabo 	 garçon 	 family 
 kognicio 	 connaissance 	 education 
 kolo 	 cou 	 anatomy 
 koloro 	 teinte 	 art 
 koloroj 	 couleur 	 art 
 kolumo 	 col 	 clothes 
 komandi 	 contrôler 	 verb 
 komenciĝi 	 débuter 	 verb 
 komenco 	 début 	 abstract 
 komerco 	 affaire 	 business 
 komisiono 	 conseil 	 society 
 kompari 	 comparer 	 verb 
 komparo 	 confrontation 	 abstract 
 kompleta 	 complet 	 adjective 
 kompleto 	 collection 	 sports 
 kompleto 	 série 	 mathematics 
 kompreni 	 comprendre 	 verb 
 kompreni 	 saisir 	 verb 
 komputero 	 ordinateur 	 device 
 komuna 	 commun 	 adjective 
 komunumo 	 communauté 	 society 
 koncedi 	 accepter 	 verb 
 koncerto 	 concert 	 art 
 koncilio 	 conseil 	 society 
 kondimenti 	 relever 	 verb 
 kondiĉo 	 condition 	 abstract 
 kondukado 	 direction 	 society 
 konduki 	 conduire 	 verb 
 konduti 	 procéder 	 verb 
 konduto 	 conduite 	 abstract 
 konkurado 	 concurrence 	 society 
 konkuranto 	 concurrent 	 business 
 konkurenco 	 concurrence 	 business 
 konscia 	 conscient 	 adjective 
 konsekvenco 	 conséquence 	 medicine 
 konsenti 	 être d'accord 	 verb 
 konservi 	 tenir 	 verb 
 konsideri 	 considérer 	 verb 
 konsilo 	 conseil 	 communication 
 konstruado 	 construction 	 house 
 konstrui 	 bâtir 	 verb 
 kontrakto 	 contrat 	 business 
 kontraux 	 contre 	 preposition 
 kontrauxa 	 opposé 	 adjective 
 kopii 	 copier 	 verb 
 kopio 	 copie 	 object 
 koramikino 	 copine 	 family 
 korbo 	 panier 	 object 
 korespondi 	 aller 	 verb 
 koro 	 coeur 	 anatomy 
 kosmo 	 espace 	 mathematics 
 kosto 	 frais 	 society 
 kosto 	 prix 	 business 
 kostumo 	 mise 	 clothes 
 kotono 	 coton 	 material 
 koverto 	 enveloppe 	 object 
 kovrilo 	 couvercle 	 object 
 krajono 	 crayon 	 object 
 kravato 	 cravate 	 clothes 
 kredi 	 croire 	 verb 
 kreski 	 augmenter 	 verb 
 kreski 	 croître 	 verb 
 kresko 	 agrandissement 	 abstract 
 kriegi 	 glapir 	 verb 
 krimo 	 délit 	 society 
 kriterio 	 critère 	 communication 
 krocxilo 	 agrafe 	 object 
 kruda 	 approximatif 	 adjective 
 kruda 	 grossier 	 adjective 
 kruro 	 jambe 	 anatomy 
 kudri 	 coudre 	 verb 
 kudrilo 	 aiguille 	 medicine 
 kuiradi 	 cuisiner 	 verb 
 kuirejo 	 cuisine 	 house 
 kuirforno 	 four 	 device 
 kuiri 	 cuisiner 	 verb 
 kuiristo 	 cuisinier 	 profession 
 kuko 	 gâteau 	 food 
 kulero 	 cuiller 	 food 
 kulturo 	 culture 	 society 
 kun 	 avec 	 preposition 
 kune 	 ensemble 	 adverb 
 kunligi 	 joindre 	 verb 
 kuracado 	 traitement 	 abstract 
 kuranta 	 actuel 	 adjective 
 kuraĝigi 	 animer 	 verb 
 kurbo 	 arc 	 art 
 kurbo 	 courbure 	 mathematics 
 kuri 	 courir 	 verb 
 kurso 	 cours 	 education 
 kurta 	 court 	 adjective 
 kurteno 	 rideau 	 house 
 kusxi 	 reposer 	 verb 
 kutime 	 normalement 	 adverb 
 kvadrata 	 carré 	 adjective 
 kvadrato 	 carré 	 mathematics 
 kvadrato 	 carré 	 mathematics 
 kvalito 	 qualité 	 abstract 
 kvar 	 quatre 	 number 
 kvara 	 quatrième 	 number 
 kvardek 	 quarante 	 number 
 kvieta 	 tranquille 	 adjective 
 kvieteco 	 silence 	 abstract 
 kvin 	 cinq 	 number 
 kvina 	 cinquième 	 number 
 kvindek 	 cinquante 	 number 
 la 	 la 	 article 
 labori 	 travailler 	 verb 
 laboristo 	 employé 	 profession 
 laboro 	 oeuvre 	 abstract 
 laboro 	 travail 	 abstract 
 laca 	 fatigué 	 adjective 
 ladskatolo 	 boîte 	 object 
 lago 	 lac 	 nature 
 lakto 	 lait 	 food 
 lamentinda 	 triste 	 adjective 
 lango 	 langue 	 anatomy 
 lano 	 laine 	 material 
 lanta 	 lent 	 adjective 
 lante 	 lentement 	 adverb 
 largxa 	 large 	 adjective 
 lasta 	 dernier 	 adjective 
 latero 	 côté 	 mathematics 
 laux 	 le long de 	 adverb 
 lauxta 	 fort 	 adjective 
 lavi 	 laver 	 verb 
 lavkuvo 	 évier 	 house 
 ledo 	 cuir 	 material 
 lefta 	 gauche 	 adjective 
 legi 	 lire 	 verb 
 leono 	 lion 	 animal 
 lernanto 	 étudiant 	 profession 
 lernejo 	 école 	 city 
 lerni 	 étudier 	 verb 
 lerta 	 expert 	 adjective 
 lerteco 	 adresse 	 sports 
 levi 	 intensifier 	 verb 
 levi 	 lever 	 verb 
 leĝa 	 légal 	 adjective 
 leĝo 	 loi 	 society 
 li 	 le 	 pronoun 
 li 	 lui 	 pronoun 
 lia 	 sa 	 pronoun 
 libera 	 libre 	 adjective 
 liberigi 	 dégager 	 verb 
 libro 	 livre 	 object 
 lifto 	 ascenseur 	 device 
 ligno 	 bois 	 material 
 likva 	 liquide 	 adjective 
 likva 	 liquide 	 nature 
 limigi 	 contenir 	 verb 
 limito 	 limite 	 mathematics 
 lingvo 	 langage 	 communication 
 lipo 	 lèvre 	 anatomy 
 listo 	 liste 	 abstract 
 litero 	 lettre 	 linguistics 
 litero 	 lettre 	 object 
 lito 	 lit 	 house 
 liveri 	 fournir 	 verb 
 liveri 	 remettre 	 verb 
 logxantaro 	 population 	 society 
 loka 	 local 	 adjective 
 loko 	 lieu 	 abstract 
 longa 	 long 	 adjective 
 ludanto 	 joueur 	 sports 
 ludi 	 jouer 	 verb 
 ludo 	 jeu 	 mathematics 
 ludo 	 jeu 	 sports 
 lumo 	 lumière 	 nature 
 lundo 	 lundi 	 time 
 luno 	 lune 	 nature 
 majusklo 	 majuscule 	 linguistics 
 majxora 	 majeur 	 adjective 
 malalta 	 bas 	 adjective 
 malami 	 mépriser 	 verb 
 malamo 	 haine 	 relations 
 malantaux 	 derrière 	 adverb 
 malbela 	 laid 	 adjective 
 malbona 	 mauvais 	 adjective 
 maldika 	 maigre 	 adjective 
 maldorma 	 éveillé 	 adjective 
 maldungi 	 licencier 	 verb 
 malfacila 	 dur 	 adjective 
 malfacileco 	 difficulté 	 abstract 
 malfermi 	 ouvrir 	 verb 
 malfrue 	 tard 	 adverb 
 malgaja 	 triste 	 adjective 
 malgranda 	 petit 	 adjective 
 malgrasa 	 maigre 	 adjective 
 malgrauxe 	 cependant 	 adverb 
 malgraŭ 	 nonobstant 	 preposition 
 malgxusta 	 mal 	 adjective 
 maljuna 	 vieux 	 adjective 
 malmulta 	 peu 	 adjective 
 malmulta 	 peu 	 adverb 
 malmultekosta 	 économique 	 adjective 
 malo 	 contraire 	 abstract 
 malpeza 	 léger 	 adjective 
 malpura 	 sale 	 adjective 
 malpura 	 sale 	 adjective 
 malricxa 	 indigent 	 adjective 
 malriĉa 	 pauvre 	 adjective 
 malsana 	 malade 	 adjective 
 malsano 	 maladie 	 medicine 
 malsanulejo 	 hôpital 	 city 
 malsata 	 affamé 	 adjective 
 malseka 	 mouillé 	 adjective 
 malsekigi 	 mouiller 	 verb 
 malsupren 	 bas 	 adverb 
 malvarma 	 froid 	 adjective 
 malvarmo 	 froid 	 nature 
 malvarmumo 	 rhume 	 medicine 
 malvasta 	 étroit 	 adjective 
 maniero 	 manière 	 mathematics 
 mano 	 main 	 anatomy 
 mansaketo 	 sac 	 clothes 
 manĝi 	 manger 	 verb 
 manĝo 	 repas 	 food 
 mapo 	 carte 	 object 
 maristo 	 marin 	 profession 
 marko 	 marque 	 abstract 
 maro 	 mer 	 nature 
 marsxi 	 marcher 	 verb 
 martelo 	 marteau 	 object 
 maskla 	 mâle 	 adjective 
 masklo 	 mâle 	 society 
 maso 	 masse 	 physics 
 matcxo 	 partie 	 sports 
 matenmangxo 	 déjeuner 	 food 
 mateno 	 matin 	 time 
 materia 	 matériel 	 adjective 
 materialo 	 matériau 	 material 
 materio 	 matière 	 material 
 mebloj 	 mobilier 	 house 
 medicina 	 médical 	 adjective 
 medio 	 milieu 	 nature 
 membro 	 membre 	 society 
 memoro 	 mémoire 	 communication 
 memoro 	 mémoire 	 communication 
 mencii 	 citer 	 verb 
 mendo 	 ordre 	 society 
 menso 	 esprit 	 mathematics 
 mensogi 	 mentir 	 verb 
 mensogo 	 mensonge 	 communication 
 mentono 	 menton 	 anatomy 
 menuo 	 menu 	 object 
 merkredo 	 mercredi 	 time 
 metala 	 métallique 	 adjective 
 metalo 	 métal 	 material 
 meti 	 pondre 	 verb 
 metodo 	 méthode 	 mathematics 
 metroo 	 métro 	 transport 
 metropolo 	 ville 	 society 
 meznombro 	 milieu 	 mathematics 
 mezurado 	 mesurage 	 art 
 mezuri 	 mesurer 	 verb 
 mezuro 	 mesure 	 abstract 
 mia 	 mon 	 pronoun 
 mil 	 mille 	 number 
 miliono 	 million 	 number 
 militisto 	 militaire 	 adjective 
 min 	 me 	 pronoun 
 minejo 	 mine 	 object 
 ministro 	 ministre 	 profession 
 minuto 	 minute 	 time 
 minuto 	 moment 	 time 
 modelo 	 patron 	 object 
 moderna 	 moderne 	 adjective 
 moderna 	 moderne 	 adjective 
 modo 	 mode 	 abstract 
 mola 	 doux 	 adjective 
 momente 	 immédiatement 	 adverb 
 momento 	 instant 	 mathematics 
 monatajxo 	 menstruation 	 medicine 
 monato 	 mois 	 time 
 monato 	 mois 	 transport 
 monbileto 	 billet 	 business 
 mondo 	 monde 	 nature 
 mono 	 argent 	 business 
 monteto 	 colline 	 nature 
 monto 	 montagne 	 nature 
 montri 	 montrer 	 verb 
 montri 	 prouver 	 verb 
 mordi 	 mordre 	 verb 
 morgaŭ 	 demain 	 adverb 
 morta 	 crevé 	 adjective 
 morti 	 mourir 	 verb 
 mortigi 	 éliminer 	 verb 
 morto 	 mort 	 nature 
 motivo 	 raison 	 communication 
 motoro 	 moteur 	 device 
 movado 	 mouvement 	 physics 
 movi 	 bouger 	 verb 
 movo 	 mouvement 	 physics 
 multaj 	 beaucoup 	 adjective 
 multe 	 beaucoup 	 adjective 
 muro 	 mur 	 house 
 muskolo 	 muscle 	 anatomy 
 muzeo 	 musée 	 city 
 muzikisto 	 musicien 	 profession 
 muziko 	 musique 	 art 
 muŝo 	 mouche 	 animal 
 nacia 	 national 	 adjective 
 nacio 	 nation 	 society 
 najbaro 	 voisin 	 family 
 najlo 	 clou 	 object 
 naskiĝtago 	 anniversaire 	 family 
 natura 	 naturel 	 adjective 
 natura lingvo 	 langue 	 linguistics 
 naturo 	 nature 	 nature 
 nazo 	 nez 	 anatomy 
 naŭ 	 neuf 	 number 
 naŭa 	 neuvième 	 number 
 ne 	 non 	 abstract 
 ne 	 non 	 adverb 
 necesa 	 nécessaire 	 adjective 
 necesejo 	 toilettes 	 house 
 necesi 	 avoir besoin 	 verb 
 nefleksebla 	 rigide 	 adjective 
 neglekti 	 manquer 	 verb 
 negoci 	 commercer 	 verb 
 negocisto 	 négociant 	 profession 
 negxi 	 neiger 	 verb 
 negxo 	 neige 	 nature 
 nelge 	 récemment 	 adverb 
 nenia 	 aucun 	 adjective 
 nenio 	 rien 	 mathematics 
 nervo 	 nerf 	 anatomy 
 neĝo 	 neige 	 nature 
 ni 	 nous 	 pronoun 
 nia 	 nous 	 pronoun 
 nigra 	 noir 	 adjective 
 nin 	 nous 	 pronoun 
 niveli 	 égaliser 	 verb 
 nodo 	 noeud 	 object 
 nokto 	 nuit 	 nature 
 noktomezo 	 minuit 	 time 
 nombro 	 nombre 	 linguistics 
 nombro 	 quantité 	 abstract 
 nomi 	 nommer 	 verb 
 nomo 	 nom 	 linguistics 
 norda 	 nord 	 adjective 
 nordo 	 nord 	 logistics 
 normala 	 normal 	 adjective 
 normala 	 normal 	 adjective 
 noto 	 note 	 communication 
 noto 	 note 	 education 
 nova 	 neuf 	 adjective 
 novaĵo 	 nouvelles 	 society 
 novembro 	 novembre 	 time 
 nubo 	 nuage 	 nature 
 nukso 	 fruit sec 	 food 
 nun 	 maintenant 	 time 
 nuna 	 présent 	 adjective 
 nuntempe 	 actuellement 	 adverb 
 nupto 	 mariage 	 family 
 nur 	 seulement 	 adverb 
 nutraĵo 	 nourriture 	 food 
 observi 	 regarder 	 verb 
 odori 	 embaumer 	 verb 
 odori 	 sentir 	 verb 
 odoro 	 odeur 	 nature 
 oferti 	 offrir 	 verb 
 oferto 	 offre 	 abstract 
 oficejo 	 bureau 	 business 
 oficisto 	 fonctionnaire 	 profession 
 ofte 	 souvent 	 adverb 
 ok 	 huit 	 number 
 oka 	 huitieme 	 number 
 okazi 	 arriver 	 verb 
 okazo 	 occasion 	 abstract 
 okazo 	 événement 	 abstract 
 okcidento 	 ouest 	 logistics 
 okdek 	 quatre-vingts 	 number 
 oktobro 	 octobre 	 time 
 okulo 	 oeil 	 anatomy 
 okupo 	 occupation 	 business 
 ol 	 que 	 conjunction 
 oleo 	 huile 	 material 
 ondo 	 vague 	 nature 
 operacio 	 opération 	 abstract 
 opinii 	 réfléchir 	 verb 
 opinio 	 avis 	 communication 
 ora 	 d'or 	 color 
 orangxa 	 orange 	 color 
 oranĝo 	 orange 	 food 
 ordeno 	 ordre 	 society 
 ordo 	 ordre 	 linguistics 
 ordoni 	 ordonner 	 verb 
 orelo 	 oreille 	 anatomy 
 organizado 	 organisation 	 society 
 oriento 	 est 	 logistics 
 origina 	 original 	 adjective 
 originalo 	 original 	 object 
 origino 	 source 	 transport 
 orkestro 	 orchestre 	 art 
 oro 	 or 	 material 
 ortografio 	 orthographe 	 linguistics 
 osto 	 os 	 anatomy 
 ovo 	 oeuf 	 food 
 pacienca 	 patient 	 adjective 
 paciento 	 patient 	 medicine 
 paco 	 paix 	 abstract 
 pafi 	 tirer 	 verb 
 pafilo 	 fusil 	 object 
 pagi 	 payer 	 verb 
 pako 	 paquet 	 object 
 palpi 	 sentir 	 verb 
 palto 	 manteau 	 clothes 
 pano 	 pain 	 food 
 papero 	 papier 	 material 
 para 	 pair 	 adjective 
 paralela 	 parallèle 	 adjective 
 pardoni 	 pardonner 	 verb 
 parko 	 parc 	 city 
 paro 	 couple 	 number 
 parolado 	 langue 	 linguistics 
 paroli 	 parler 	 verb 
 parto 	 partie 	 abstract 
 parto 	 partie 	 society 
 pasagxero 	 passager 	 transport 
 pasinta 	 passé 	 adjective 
 pasporto 	 passeport 	 object 
 pasxo 	 pas 	 mathematics 
 patrino 	 maman 	 family 
 patro 	 papa 	 family 
 pauxzo 	 récréation 	 abstract 
 paĝo 	 page 	 object 
 paŭzo 	 pause 	 time 
 peco 	 copeau 	 object 
 peco 	 morceau 	 abstract 
 peco 	 morceau 	 object 
 peno 	 essai 	 abstract 
 peno 	 peine 	 abstract 
 penso 	 pensée 	 communication 
 pentrado 	 tableau 	 art 
 perdi 	 perdre 	 verb 
 perdi 	 perdre 	 verb 
 perdo 	 perte 	 business 
 perforta 	 violent 	 adjective 
 permesi 	 laisser 	 verb 
 permesi 	 permettre 	 verb 
 persona 	 personnel 	 adjective 
 personeco 	 caractère 	 abstract 
 persono 	 personne 	 family 
 peti 	 appeler 	 verb 
 peti 	 demander 	 verb 
 peto 	 demande 	 communication 
 petrolo 	 pétrole 	 material 
 peza 	 lourd 	 adjective 
 pezi 	 peser 	 verb 
 pezo 	 poids 	 physics 
 piedbato 	 coup de pied 	 abstract 
 piedfingro 	 orteil 	 anatomy 
 piedo 	 pied 	 anatomy 
 piedpilko 	 football 	 sports 
 pilko 	 ballon 	 object 
 piloto 	 pilote 	 profession 
 pinglo 	 épingle 	 object 
 pisti 	 écraser 	 verb 
 plani 	 concevoir 	 verb 
 plani 	 organiser 	 verb 
 planko 	 sol 	 house 
 plano 	 plan 	 abstract 
 planto 	 plante 	 house 
 plata 	 plan 	 adjective 
 plejparto 	 majorité 	 abstract 
 plena 	 plein 	 adjective 
 plenigi 	 emplir 	 verb 
 plezuro 	 plaisir 	 abstract 
 pli 	 plus 	 adjective 
 plibonigi 	 améliorer 	 verb 
 pliigo 	 augmentation 	 abstract 
 plimalgrandigi 	 réduire 	 verb 
 plori 	 pleurer 	 verb 
 plue 	 plus 	 adjective 
 plugi 	 labourer 	 verb 
 plumbo 	 plomb 	 material 
 plumo 	 plume 	 object 
 plumo 	 plume 	 object 
 pluvi 	 pleuvoir 	 verb 
 pluvo 	 pluie 	 nature 
 pluvo 	 pluie 	 nature 
 poemo 	 poème 	 art 
 poezio 	 poésie 	 art 
 pokalo 	 coupe 	 object 
 policano 	 policier 	 profession 
 polico 	 police 	 society 
 politika 	 politique 	 adjective 
 politikisto 	 politicien 	 profession 
 politiko 	 politique 	 society 
 poluri 	 cirer 	 verb 
 polvo 	 poussière 	 material 
 polvo 	 poussière 	 material 
 pomo 	 pomme 	 food 
 ponto 	 pont 	 object 
 popolamaso 	 peuple 	 society 
 pordego 	 barrière 	 house 
 pordo 	 porte 	 house 
 porko 	 porc 	 animal 
 porti 	 mettre 	 verb 
 porti 	 porter 	 verb 
 porti 	 porter 	 verb 
 posedanto 	 possesseur 	 business 
 post 	 sur 	 adjective 
 poste 	 ensuite 	 adverb 
 posttagmezo 	 après-midi 	 time 
 povo 	 capacité 	 abstract 
 povo 	 faculté 	 abstract 
 pozicio 	 poste 	 linguistics 
 poŝtelefono 	 téléphone cellulaire 	 device 
 poŝto 	 poste 	 communication 
 praktiko 	 clientèle 	 art 
 prefere 	 plutôt 	 adverb 
 premo 	 pression 	 nature 
 preni 	 saisir 	 verb 
 presi 	 imprimer 	 verb 
 preskaux 	 presque 	 adverb 
 preta 	 prêt 	 adjective 
 pretigi 	 préparer 	 verb 
 preventi 	 empêcher 	 verb 
 prezenti 	 présenter 	 verb 
 prezenti 	 présenter 	 verb 
 prezidento 	 président 	 profession 
 prezo 	 prix 	 transport 
 prilabori 	 traiter 	 verb 
 printempo 	 printemps 	 nature 
 priskribi 	 décrire 	 verb 
 privata 	 privé 	 adjective 
 prizono 	 prison 	 city 
 problemo 	 problème 	 abstract 
 problemo 	 problème 	 mathematics 
 procedo 	 méthode 	 mathematics 
 produktado 	 production 	 abstract 
 produkto 	 produit 	 object 
 profesia 	 professionnel 	 adjective 
 profesiisto 	 professionnel 	 profession 
 profiti 	 profit 	 verb 
 profito 	 gain 	 business 
 programo 	 programme 	 abstract 
 proklamo 	 communiqué 	 communication 
 proksima 	 proche 	 adjective 
 proksimume 	 environ 	 adverb 
 prononco 	 prononciation 	 linguistics 
 proponi 	 suggérer 	 verb 
 propono 	 proposition 	 abstract 
 propono 	 proposition 	 abstract 
 propra 	 propre 	 adjective 
 protesti 	 protester 	 verb 
 protesto 	 objection 	 communication 
 prototipo 	 prototype 	 linguistics 
 provi 	 essayer 	 verb 
 publika 	 public 	 travelling 
 publikigi 	 promulguer 	 verb 
 pumpi 	 pomper 	 verb 
 pumpilo 	 pompe 	 device 
 punkto 	 point 	 linguistics 
 puno 	 châtiment 	 society 
 pura 	 propre 	 adjective 
 purigi 	 polir 	 verb 
 puto 	 puits 	 object 
 puŝi 	 pousser 	 verb 
 radiko 	 racine 	 mathematics 
 radiko 	 racine 	 nature 
 rado 	 roue 	 object 
 rapida 	 rapide 	 logistics 
 rapide 	 vite 	 adverb 
 raporto 	 rapport 	 abstract 
 reago 	 réaction 	 abstract 
 redoni 	 rendre 	 verb 
 ree 	 encore 	 adverb 
 reflekti 	 réfléchir 	 verb 
 regado 	 gouvernement 	 society 
 regi 	 gouverner 	 verb 
 regiono 	 région 	 nature 
 registri 	 enregistrer 	 verb 
 regula 	 habituel 	 adjective 
 regulo 	 règlement 	 linguistics 
 regxa 	 royal 	 adjective 
 regxo 	 roi 	 society 
 reklamo 	 annonce 	 business 
 rekompenco 	 récompense 	 society 
 rekordo 	 record 	 abstract 
 rekta 	 droit 	 adjective 
 rekte 	 directement 	 adverb 
 religio 	 religion 	 society 
 relo 	 rail 	 transport 
 rendevuo 	 rendez-vous 	 relations 
 renkonti 	 rencontrer 	 verb 
 renkontigxo 	 rencontre 	 communication 
 reprezentanto 	 représentant 	 profession 
 reprezenti 	 représenter 	 verb 
 respondeca 	 responsable 	 adjective 
 respondeco 	 responsabilité 	 abstract 
 respondi 	 répondre 	 verb 
 respondo 	 réponse 	 communication 
 respubliko 	 république 	 society 
 resti 	 rester 	 verb 
 resto 	 reste 	 business 
 restoracio 	 restaurant 	 city 
 reto 	 filet 	 material 
 revuo 	 revue 	 object 
 rezulto 	 résultat 	 mathematics 
 ricevi 	 recevoir 	 verb 
 rideti 	 sourire 	 verb 
 rideto 	 sourire 	 abstract 
 ridi 	 rire 	 verb 
 rifuzi 	 refuser 	 verb 
 rigardi 	 regarder 	 verb 
 rigardo 	 regard 	 communication 
 rilato 	 relation 	 communication 
 ringo 	 anneau 	 clothes 
 riporti 	 signaler 	 verb 
 ripozi 	 se reposer 	 verb 
 ripozo 	 repos 	 abstract 
 riski 	 risquer 	 verb 
 risko 	 aléa 	 transport 
 risorto 	 ressort 	 object 
 ritmo 	 rythme 	 art 
 riveli 	 révéler 	 verb 
 rivero 	 fleuve 	 nature 
 rizo 	 riz 	 food 
 rizo 	 riz 	 food 
 rompi 	 rompre 	 verb 
 rompita 	 cassé 	 adjective 
 rondigi 	 arrondir 	 verb 
 rondo 	 cercle 	 mathematics 
 rozkolora 	 rose 	 color 
 rubo 	 déchets 	 material 
 rugxa 	 rouge 	 color 
 ruro 	 pays 	 society 
 ruzo 	 ruse 	 abstract 
 sabato 	 samedi 	 time 
 sablo 	 sable 	 material 
 sagaca 	 astucieux 	 adjective 
 sagxa 	 sage 	 adjective 
 saketo 	 poche 	 object 
 salato 	 salade 	 food 
 sali 	 saler 	 verb 
 salo 	 sel 	 food 
 salti 	 sauter 	 verb 
 salto 	 saut 	 abstract 
 salubra 	 salubre 	 adjective 
 sama 	 même 	 adjective 
 sandvicxo 	 sandwich 	 food 
 sango 	 sang 	 anatomy 
 sano 	 santé 	 abstract 
 sano 	 santé 	 medicine 
 sapi 	 savonner 	 verb 
 sapo 	 savon 	 material 
 sauxco 	 sauce 	 food 
 savi 	 assurer 	 verb 
 scenejo 	 scène 	 object 
 scienco 	 science 	 society 
 scienculo 	 scientifique 	 profession 
 scii 	 savoir 	 verb 
 se 	 si 	 conjunction 
 seka 	 sec 	 adjective 
 sekcio 	 département 	 society 
 sekcio 	 rayon 	 mathematics 
 sekigi 	 essuyer 	 verb 
 sekigi 	 sécher 	 verb 
 sekreta 	 secret 	 communication 
 sekretario 	 secrétaire 	 profession 
 sekso 	 sexe 	 nature 
 sekso 	 sexe 	 relations 
 sekundo 	 seconde 	 time 
 sekura 	 sûr 	 adjective 
 sekvi 	 suivre 	 verb 
 semajnfino 	 weekend 	 time 
 semajno 	 semaine 	 time 
 senbrua 	 calme 	 adjective 
 sendi 	 poster 	 verb 
 senlabora 	 chômeur 	 adjective 
 senpaga 	 gratuit 	 adjective 
 sento 	 sentiment 	 communication 
 sep 	 sept 	 number 
 sepa 	 septième 	 number 
 sepdek 	 soixante-dix 	 number 
 sereneco 	 sérénité 	 abstract 
 serioza 	 grave 	 adjective 
 serpento 	 serpent 	 animal 
 seruro 	 serrure 	 house 
 servado 	 service 	 sports 
 ses 	 six 	 number 
 sesa 	 sixième 	 number 
 sesdek 	 soixante 	 number 
 sezono 	 saison 	 nature 
 seĝo 	 chaise 	 house 
 sidi 	 poser 	 verb 
 signifoplena 	 important 	 adjective 
 silko 	 soie 	 material 
 simila 	 semblable 	 adjective 
 simio 	 singe 	 animal 
 simpla 	 simple 	 adjective 
 sincera 	 sincère 	 adjective 
 sinuo 	 anse 	 transport 
 sistemo 	 système 	 linguistics 
 situacio 	 situation 	 abstract 
 skribi 	 écrire 	 verb 
 skribo 	 écriture 	 linguistics 
 skribotablo 	 bureau 	 house 
 sociala 	 social 	 adjective 
 socio 	 société 	 society 
 soifa 	 assoiffé 	 adjective 
 sola 	 seul 	 adjective 
 sola 	 solitaire 	 adjective 
 soldato 	 militaire 	 profession 
 sole 	 seul 	 adverb 
 somero 	 été 	 nature 
 sono 	 audio 	 abstract 
 sono 	 son 	 nature 
 sonorilo 	 cloche 	 object 
 spaco 	 aire 	 mathematics 
 speciala 	 spécial 	 adjective 
 speciale 	 particulièrement 	 adverb 
 specifa 	 spécifique 	 adjective 
 speco 	 espèce 	 abstract 
 speco 	 sorte 	 abstract 
 spegulo 	 miroir 	 house 
 spermo 	 graine 	 food 
 sperto 	 expérience 	 society 
 spertulo 	 expert 	 profession 
 stacio 	 poste 	 society 
 stampilo 	 tampon 	 object 
 stari 	 être debout 	 verb 
 stato 	 état 	 mathematics 
 stilo 	 style 	 art 
 stiri 	 conduire 	 verb 
 stomako 	 estomac 	 anatomy 
 strando 	 plage 	 nature 
 stranga 	 bizarre 	 adjective 
 strato 	 route 	 city 
 streko 	 ligne 	 mathematics 
 strikta 	 serré 	 adjective 
 strukturo 	 structure 	 linguistics 
 studi 	 étudier 	 verb 
 stulta 	 sot 	 adjective 
 stulta 	 stupide 	 adjective 
 sub 	 au-dessous 	 adjective 
 suben 	 bas 	 adjective 
 subita 	 soudain 	 adjective 
 subite 	 subitement 	 adverb 
 subjekto 	 sujet 	 linguistics 
 substituo 	 échange 	 abstract 
 subteni 	 soutenir 	 verb 
 sudo 	 sud 	 logistics 
 suferi 	 endurer 	 verb 
 suficxe 	 assez 	 adverb 
 sukcesa 	 fructueux 	 adjective 
 sukceso 	 succès 	 society 
 sukero 	 sucre 	 food 
 sumo 	 montant 	 mathematics 
 suno 	 soleil 	 nature 
 super 	 dessus 	 adverb 
 superbazaro 	 supermarché 	 city 
 superi 	 dépasser 	 verb 
 supo 	 soupe 	 food 
 supozi 	 supposer 	 verb 
 supren 	 haut 	 adverb 
 supro 	 sommet 	 abstract 
 surfaco 	 surface 	 mathematics 
 surprizi 	 surprendre 	 verb 
 surprizo 	 surprise 	 abstract 
 suturero 	 point 	 medicine 
 sxargajxo 	 charge 	 nature 
 sxargxi 	 charger 	 verb 
 sxia 	 son 	 pronoun 
 sxlosi 	 fermer 	 verb 
 sxranko 	 placard 	 house 
 sxteli 	 voler 	 verb 
 sxtofo 	 étoffe 	 material 
 sxtupo 	 marche 	 house 
 tabelo 	 table 	 object 
 tablo 	 table 	 house 
 tagmanĝo 	 déjeuner 	 food 
 tago 	 journée 	 nature 
 taksi 	 apprécier 	 verb 
 taksi 	 estimer 	 verb 
 tapiŝo 	 tapis 	 house 
 tasko 	 travail 	 business 
 tasko 	 tâche 	 abstract 
 taso 	 coupe 	 food 
 teamo 	 équipe 	 society 
 teatro 	 théâtre 	 city 
 teda 	 ennuyeux 	 adjective 
 tegmento 	 toit 	 house 
 teknologio 	 technologie 	 society 
 telefoncentralo 	 central 	 society 
 telero 	 assiette 	 food 
 tempo 	 temps 	 physics 
 tendenco 	 tendance 	 abstract 
 tenebra 	 foncé 	 adjective 
 teni 	 tenir 	 verb 
 teniso 	 tennis 	 sports 
 teo 	 thé 	 food 
 teorio 	 théorie 	 education 
 tero 	 raison 	 communication 
 tero 	 sol 	 material 
 terpomo 	 pomme de terre 	 food 
 testamento 	 testament 	 society 
 testi 	 essayer 	 verb 
 tia 	 tel 	 adverb 
 tiam 	 alors 	 adverb 
 tie 	 là 	 adverb 
 tiel 	 ainsi 	 adverb 
 tigo 	 tige 	 nature 
 timi 	 craindre 	 verb 
 timo 	 peur 	 relations 
 tiri 	 tirer 	 verb 
 tirkesto 	 tiroir 	 house 
 titoli 	 intituler 	 verb 
 titolo 	 championnat 	 sports 
 titolo 	 titre 	 society 
 tiu 	 ce 	 pronoun 
 tiu cxi 	 cette 	 pronoun 
 tomato 	 tomate 	 food 
 tondilo 	 ciseaux 	 object 
 tononomo 	 note 	 art 
 torso 	 tronc 	 anatomy 
 totala 	 complet 	 adjective 
 trajno 	 train 	 transport 
 trakti 	 traiter 	 verb 
 trancxi 	 couper 	 verb 
 transporti 	 transporter 	 verb 
 transporto 	 transport 	 transport 
 tranĉilo 	 couteau 	 food 
 travivi 	 éprouver 	 verb 
 tre 	 très 	 adverb 
 trejnado 	 entraînement 	 abstract 
 trejni 	 former 	 verb 
 tri 	 trois 	 number 
 tria 	 troisième 	 mathematics 
 tribunalo 	 tribunal 	 society 
 tridek 	 trente 	 number 
 trinkajxo 	 boisson 	 food 
 trinki 	 boire 	 verb 
 trovi 	 trouver 	 verb 
 trovi 	 trouver 	 verb 
 truo 	 trou 	 abstract 
 tubaro 	 tuyauterie 	 object 
 turni 	 tourner 	 verb 
 tusi 	 tousser 	 verb 
 tuso 	 toux 	 medicine 
 tusxo 	 toucher 	 abstract 
 tuta 	 entier 	 adjective 
 tutajxo 	 tout 	 abstract 
 ungo 	 ongle 	 anatomy 
 unito 	 unité 	 mathematics 
 universitato 	 université 	 city 
 universitato 	 université 	 education 
 unue 	 d'abord 	 adverb 
 unuiĝo 	 union 	 society 
 unuopa 	 simple 	 adjective 
 urbo 	 ville 	 society 
 urso 	 ours 	 animal 
 utilo 	 profit 	 abstract 
 uzanto 	 utilisateur 	 society 
 uzi 	 utiliser 	 verb 
 uzo 	 usage 	 linguistics 
 valizo 	 valise 	 clothes 
 valoro 	 valeur 	 art 
 vaporo 	 vapeur 	 physics 
 varma 	 chaleureux 	 adjective 
 varma 	 chaud 	 adjective 
 varmego 	 chaleur 	 medicine 
 varmigi 	 chauffer 	 verb 
 velo 	 voile 	 object 
 vendejo 	 boutique 	 business 
 vendi 	 vendre 	 verb 
 vendo 	 vente 	 business 
 vendredo 	 vendredi 	 time 
 veneni 	 empoisonner 	 verb 
 veneno 	 venin 	 material 
 veni 	 venir 	 verb 
 venki 	 vaincre 	 verb 
 venonta 	 futur 	 adjective 
 venonta 	 suivant 	 adjective 
 vento 	 vent 	 nature 
 vera 	 vrai 	 adjective 
 verda 	 vert 	 color 
 vere 	 en réalité 	 adverb 
 vere 	 réellement 	 adverb 
 verema 	 vrai 	 adjective 
 verkisto 	 écrivain 	 profession 
 versxajna 	 possible 	 adjective 
 versxajne 	 vraisemblablement 	 adverb 
 vespero 	 soir 	 time 
 vestoj 	 costume 	 clothes 
 vetero 	 temps 	 nature 
 via 	 tes 	 pronoun 
 viando 	 viande 	 food 
 vidi 	 voir 	 verb 
 vilagxo 	 village 	 society 
 vilaĝo 	 village 	 society 
 vino 	 vin 	 food 
 vintro 	 hiver 	 nature 
 violkolora 	 violet 	 color 
 vipo 	 fouet 	 object 
 virino 	 femme 	 family 
 virino 	 femme 	 society 
 viskoza 	 dense 	 adjective 
 vitro 	 verre 	 material 
 vivanta 	 vif 	 adjective 
 vivi 	 vivre 	 verb 
 vivo 	 vie 	 nature 
 vizaĝo 	 visage 	 anatomy 
 viziti 	 visiter 	 verb 
 vizito 	 visite 	 abstract 
 vocxo 	 voix 	 communication 
 vojagxo 	 trajet 	 transport 
 vojo 	 chemin 	 transport 
 voko 	 cri 	 communication 
 voli 	 vouloir 	 verb 
 volo 	 volonté 	 abstract 
 vortaro 	 dictionnaire 	 linguistics 
 vorto 	 mot 	 linguistics 
 vosto 	 queue 	 anatomy 
 vundi 	 blesser 	 verb 
 Ĉeĥio 	 République tchèque 	 country 
 ĉambro 	 pièce 	 house 
 ĉapelo 	 chapeau 	 clothes 
 ĉar 	 car 	 conjunction 
 ĉefa 	 majeur 	 adjective 
 ĉefurbo 	 capitale 	 society 
 ĉelo 	 cellule 	 anatomy 
 ĉemizo 	 chemise 	 clothes 
 ĉeno 	 chaîne 	 object 
 ĉiam 	 toujours 	 adverb 
 ĉokolado 	 chocolat 	 food 
 ĝardeno 	 jardin 	 house 
 ĝenerale 	 généralement 	 adverb 
 ĝui 	 aimer 	 verb 
 ĵeto 	 lancer 	 sports 
 ĵurnalisto 	 journaliste 	 profession 
 ĵurnalo 	 journal 	 object 
 ŝafo 	 mouton 	 animal 
 ŝanĝi 	 changer 	 verb 
 ŝanĝo 	 changement 	 abstract 
 ŝi 	 elle 	 pronoun 
 ŝipo 	 navire 	 transport 
 ŝlosilo 	 clé 	 house 
 ŝnuro 	 corde 	 transport 
 ŝoko 	 choc 	 abstract 
 ŝpari 	 épargner 	 verb 
 ŝtalo 	 acier 	 material 
 ŝtato 	 état 	 society 
 ŝtato 	 état 	 society 
 ŝtono 	 caillou 	 nature 
 ŝtrumpeto 	 chaussette 	 clothes 
 ŝuo 	 chaussure 	 clothes 
