# French-Esperanto translations created from the Universal dictionary at 2011-05-28T05:46:29-06:00
# (c) Copyright 2011 by All free dictionaries project
# ALL FREE DICTIONARIES PROJECT DISCLAIMS ALL
# WARRANTIES WITH REGARD TO THESE TRANSLATIONS, INCLUDING ALL
# IMPLIED WARRANTIES OF MERCHANTABILITY AND FITNESS. IN NO
# EVENT SHALL ALL FREE DICTIONARIES PROJECT OR ANY OF ITS CONTRIBUTORS
# BE LIABLE FOR ANY SPECIAL, INDIRECT OR CONSEQUENTIAL DAMAGES
# OR ANY DAMAGES WHATSOEVER RESULTING FROM LOSS OF USE, DATA OR
# PROFITS, WHETHER IN AN ACTION OF CONTRACT, NEGLIGENCE
# OR OTHER ACTION, ARISING OUT OF OR IN CONNECTION
# WITH THE USE OR PERFORMANCE OF THESE TRANSLATIONS.
#
# In other words there may be incorrect translations.
# If you need to be sure never use these translations!
#
# French, German and Czech entries are added manually. The entries for
# remaining languages are added automatically. Entries for these languages
# are only experimental.
#
# You may not place this file on WWW, ftp and equivalent servers because
# this file gets outdated very quickly. You may not distribute this file
# with your dictionary applications without permission. You can contact
# authors of the Universal dictionary at: http://dicts.info/contact.php
#
# This file is for personal use only. You may not distribute this file.
#
# New version of this file can be created at: http://www.dicts.info/uddl.php
#

 Britain 	 Britio 	 country 
 Italie 	 Italio 	 country 
 Japon 	 Japanio 	 country 
 Royaume d'Espagne 	 Hispanujo 	 country 
 République de l'Inde 	 Hindio 	 country 
 République française 	 Francio 	 country 
 République fédérale d'Allemagne 	 Germanio 	 country 
 République tchèque 	 Ĉeĥio 	 country 
 Terre 	 Tero 	 nature 
 abdiquer 	 kapitulaci 	 verb 
 abeille 	 abelo 	 animal 
 accepter 	 akcepti 	 verb 
 accepter 	 koncedi 	 verb 
 accident 	 akcidento 	 transport 
 accusation 	 akuzo 	 society 
 accuser 	 akuzi 	 verb 
 acheter 	 aĉeti 	 verb 
 acide 	 acido 	 material 
 acier 	 ŝtalo 	 material 
 acte 	 ago 	 abstract 
 action 	 ago 	 mathematics 
 action 	 akcio 	 business 
 action 	 faro 	 mathematics 
 activité 	 ago 	 mathematics 
 actrice 	 aktorino 	 profession 
 actuel 	 kuranta 	 adjective 
 actuellement 	 nuntempe 	 adverb 
 addition 	 adicio 	 mathematics 
 additionner 	 aldoni 	 verb 
 adjacent 	 apuda 	 adjective 
 adjectif 	 adjektivo 	 linguistics 
 administrer 	 administri 	 verb 
 adresse 	 adreso 	 abstract 
 adresse 	 lerteco 	 sports 
 affaire 	 komerco 	 business 
 affamé 	 malsata 	 adjective 
 affronter 	 defii 	 verb 
 agir 	 agi 	 verb 
 agrafe 	 krocxilo 	 object 
 agrandissement 	 kresko 	 abstract 
 aide 	 helpo 	 communication 
 aiguille 	 kudrilo 	 medicine 
 aiguisé 	 akra 	 adjective 
 aile 	 flugilo 	 anatomy 
 aimer 	 ami 	 verb 
 aimer 	 ĝui 	 verb 
 ainsi 	 tiel 	 adverb 
 air 	 aero 	 nature 
 aire 	 spaco 	 mathematics 
 alentours 	 cxirkauxajxo 	 nature 
 allemand 	 Germana lingvo 	 linguistics 
 aller 	 iri 	 verb 
 aller 	 korespondi 	 verb 
 allumette 	 alumeto 	 object 
 alors 	 tiam 	 adverb 
 alternative 	 alternativo 	 abstract 
 aléa 	 risko 	 transport 
 amant 	 amisto 	 family 
 amer 	 amara 	 adjective 
 amical 	 amika 	 adjective 
 améliorer 	 plibonigi 	 verb 
 ancien 	 estinta 	 adjective 
 anglais 	 Angla lingvo 	 language 
 angle 	 angulo 	 mathematics 
 animal 	 animala 	 nature 
 animer 	 kuraĝigi 	 verb 
 anneau 	 ringo 	 clothes 
 anniversaire 	 naskiĝtago 	 family 
 annonce 	 reklamo 	 business 
 annoncer 	 anonci 	 verb 
 année 	 jaro 	 time 
 anse 	 sinuo 	 transport 
 appartement 	 apartamento 	 society 
 appeler 	 peti 	 verb 
 apporter 	 alporti 	 verb 
 approbation 	 aprobo 	 communication 
 approximatif 	 kruda 	 adjective 
 apprécier 	 taksi 	 verb 
 appui 	 apogo 	 abstract 
 après-midi 	 posttagmezo 	 time 
 arbre 	 arbo 	 house 
 arc 	 kurbo 	 art 
 argent 	 arĝento 	 material 
 argent 	 mono 	 business 
 argument 	 argumento 	 communication 
 argument 	 diskuto 	 communication 
 armée 	 armeo 	 society 
 armée 	 armeo 	 society 
 arrangement 	 interkonsento 	 business 
 arriver 	 alveni 	 verb 
 arriver 	 gajni 	 verb 
 arriver 	 okazi 	 verb 
 arrondir 	 rondigi 	 verb 
 arrêt 	 halto 	 abstract 
 arrêter 	 haltigi 	 verb 
 art 	 arto 	 art 
 artiste 	 artisto 	 profession 
 ascenseur 	 lifto 	 device 
 ascension 	 ascendo 	 abstract 
 aspect 	 aspekto 	 abstract 
 assez 	 suficxe 	 adverb 
 assiette 	 telero 	 food 
 assoiffé 	 soifa 	 adjective 
 assurance 	 asekuro 	 business 
 assurer 	 savi 	 verb 
 assurément 	 certe 	 adverb 
 astucieux 	 sagaca 	 adjective 
 attaque 	 atako 	 abstract 
 attaquer 	 ataki 	 verb 
 attendre 	 atendi 	 verb 
 attention 	 atenti 	 verb 
 attention 	 atento 	 communication 
 attraper 	 akiri 	 verb 
 au-dessous 	 sub 	 adjective 
 aucun 	 nenia 	 adjective 
 audio 	 sono 	 abstract 
 augmentation 	 pliigo 	 abstract 
 augmenter 	 kreski 	 verb 
 aujourd'hui 	 hodiaŭ 	 adverb 
 ausculter 	 aŭdi 	 verb 
 aussi 	 ankaŭ 	 adverb 
 austral 	 aŭstrala 	 adjective 
 autocar 	 aŭtobuso 	 transport 
 automatique 	 aŭtomata 	 adjective 
 automne 	 aŭtuno 	 nature 
 automobile 	 aŭtomobilo 	 transport 
 autorité 	 aŭtoritato 	 society 
 autour 	 cxirkaux 	 adverb 
 autre 	 alia 	 adjective 
 autre 	 alia 	 adjective 
 autrefois 	 iam 	 adverb 
 avant 	 antaux 	 adverb 
 avant 	 antauxajxo 	 abstract 
 avant 	 antauxen 	 adverb 
 avantage 	 avantagxo 	 abstract 
 avec 	 kun 	 preposition 
 avion 	 aeroplano 	 object 
 avis 	 opinio 	 communication 
 avoir 	 havi 	 verb 
 avoir 	 havi 	 verb 
 avoir besoin 	 necesi 	 verb 
 avril 	 aprilo 	 time 
 aérodrome 	 aerodromo 	 city 
 bain 	 bano 	 house 
 baiser 	 kisi 	 verb 
 baiser 	 kiso 	 relations 
 ballon 	 pilko 	 object 
 banque 	 banko 	 city 
 barbare 	 barbara 	 adjective 
 barrière 	 pordego 	 house 
 bas 	 malalta 	 adjective 
 bas 	 malsupren 	 adverb 
 bas 	 suben 	 adjective 
 base 	 bazo 	 mathematics 
 base 	 bazo 	 society 
 base-ball 	 basbalo 	 sports 
 bateau 	 boato 	 object 
 beau 	 bela 	 adjective 
 beaucoup 	 multaj 	 adjective 
 beaucoup 	 multe 	 adjective 
 bec 	 beko 	 anatomy 
 besoin 	 bezono 	 abstract 
 beurre 	 butero 	 food 
 bibliothèque 	 biblioteko 	 city 
 bicyclette 	 biciklo 	 object 
 bien 	 bone 	 adverb 
 bientôt 	 baldaux 	 adverb 
 bijou 	 juvelo 	 object 
 billet 	 bileto 	 object 
 billet 	 monbileto 	 business 
 biologie 	 biologio 	 science 
 bizarre 	 stranga 	 adjective 
 bière 	 biero 	 food 
 blanc 	 blanka 	 adjective 
 blesser 	 damagxi 	 verb 
 blesser 	 vundi 	 verb 
 bleu 	 blua 	 color 
 boire 	 trinki 	 verb 
 bois 	 ligno 	 material 
 boisson 	 trinkajxo 	 food 
 bon 	 bona 	 adjective 
 bon 	 bona 	 adjective 
 bord 	 eĝo 	 mathematics 
 botte 	 boto 	 clothes 
 bouche 	 buŝo 	 anatomy 
 bouger 	 movi 	 verb 
 bouteille 	 botelo 	 food 
 boutique 	 vendejo 	 business 
 bouton 	 butono 	 object 
 boîte 	 ladskatolo 	 object 
 branche 	 brancxo 	 nature 
 bras 	 brako 	 anatomy 
 brique 	 briko 	 house 
 brosse 	 broso 	 object 
 bruit 	 bruo 	 society 
 brusque 	 bruska 	 adjective 
 bureau 	 oficejo 	 business 
 bureau 	 skribotablo 	 house 
 but 	 golo 	 sports 
 bâtir 	 konstrui 	 verb 
 bâton 	 bastono 	 object 
 bébé 	 infaneto 	 family 
 cadre 	 framo 	 object 
 café 	 kafo 	 food 
 cageot 	 kesteto 	 object 
 caillou 	 ŝtono 	 nature 
 calculateur 	 kalkulilo 	 device 
 calme 	 senbrua 	 adjective 
 caméra 	 fotoaparato 	 object 
 capable 	 kapabla 	 adjective 
 capacité 	 povo 	 abstract 
 capital 	 kapitalo 	 business 
 capitale 	 ĉefurbo 	 society 
 car 	 cxar 	 conjunction 
 car 	 ĉar 	 conjunction 
 caractère 	 karaktero 	 abstract 
 caractère 	 karaktro 	 linguistics 
 caractère 	 personeco 	 abstract 
 caractéristique 	 atributo 	 abstract 
 carré 	 kvadrata 	 adjective 
 carré 	 kvadrato 	 mathematics 
 carré 	 kvadrato 	 mathematics 
 carte 	 karto 	 object 
 carte 	 mapo 	 object 
 cassé 	 rompita 	 adjective 
 cause 	 kauxzo 	 abstract 
 ce 	 tiu 	 pronoun 
 cellule 	 cxelo 	 society 
 cellule 	 ĉelo 	 anatomy 
 cent 	 cent 	 number 
 central 	 centra 	 adjective 
 central 	 kardinala 	 adjective 
 central 	 telefoncentralo 	 society 
 centre 	 centro 	 mathematics 
 cependant 	 malgrauxe 	 adverb 
 cercle 	 rondo 	 mathematics 
 certain 	 certa 	 adjective 
 cerveau 	 cerbo 	 anatomy 
 cette 	 tiu cxi 	 pronoun 
 chacun 	 cxiu 	 adjective 
 chacun 	 cxiu 	 adjective 
 chaise 	 seĝo 	 house 
 chaleur 	 varmego 	 medicine 
 chaleureux 	 varma 	 adjective 
 chambre à coucher 	 dormcxambro 	 house 
 championnat 	 titolo 	 sports 
 chanceux 	 bonŝanca 	 adjective 
 changement 	 ŝanĝo 	 abstract 
 changer 	 ŝanĝi 	 verb 
 chanson 	 kanzono 	 art 
 chanteur 	 kantisto 	 profession 
 chapeau 	 ĉapelo 	 clothes 
 charbon 	 karbo 	 material 
 charge 	 sxargajxo 	 nature 
 charger 	 sxargxi 	 verb 
 chat 	 kato 	 animal 
 chaud 	 varma 	 adjective 
 chauffer 	 varmigi 	 verb 
 chaussette 	 ŝtrumpeto 	 clothes 
 chaussure 	 ŝuo 	 clothes 
 chaîne 	 ĉeno 	 object 
 chef 	 cxefo 	 society 
 chef 	 estro 	 society 
 chemin 	 vojo 	 transport 
 chemise 	 ĉemizo 	 clothes 
 cheval 	 cxevalo 	 animal 
 cheveux 	 haro 	 anatomy 
 cheveux 	 haroj 	 anatomy 
 chien 	 hundo 	 animal 
 chimie 	 kemio 	 science 
 chimique 	 kemia 	 adjective 
 chimique 	 kemiaĵo 	 material 
 choc 	 ŝoko 	 abstract 
 chocolat 	 ĉokolado 	 food 
 choisir 	 elekti 	 verb 
 chose 	 ajxo 	 object 
 chute 	 falo 	 abstract 
 château 	 kastelo 	 city 
 châtiment 	 puno 	 society 
 chèque 	 cxeko 	 business 
 chèvre 	 kapro 	 animal 
 chômeur 	 senlabora 	 adjective 
 ciel 	 cxielo 	 nature 
 cinq 	 kvin 	 number 
 cinquante 	 kvindek 	 number 
 cinquième 	 kvina 	 number 
 cinéma 	 kino 	 city 
 cirer 	 poluri 	 verb 
 ciseaux 	 tondilo 	 object 
 citer 	 mencii 	 verb 
 clair 	 hela 	 adjective 
 clair 	 hela 	 adjective 
 classe 	 klaso 	 art 
 classer 	 klasi 	 verb 
 clayette 	 bretaro 	 house 
 clientèle 	 praktiko 	 art 
 cloche 	 sonorilo 	 object 
 clore 	 fermi 	 verb 
 clou 	 najlo 	 object 
 club 	 gildo 	 society 
 clé 	 ŝlosilo 	 house 
 coeur 	 koro 	 anatomy 
 coffre 	 kesto 	 object 
 col 	 kolumo 	 clothes 
 collant 	 glueca 	 adjective 
 colle 	 gluo 	 material 
 collection 	 kompleto 	 sports 
 coller 	 glui 	 verb 
 colline 	 monteto 	 nature 
 comme 	 kiel 	 adverb 
 commercer 	 negoci 	 verb 
 commettant 	 kliento 	 business 
 commun 	 komuna 	 adjective 
 communauté 	 komunumo 	 society 
 communiqué 	 proklamo 	 communication 
 compagnie 	 grupo 	 society 
 comparer 	 kompari 	 verb 
 complet 	 kompleta 	 adjective 
 complet 	 totala 	 adjective 
 composant additionnel 	 aldono 	 abstract 
 comprendre 	 inkluzivi 	 verb 
 comprendre 	 kompreni 	 verb 
 compte 	 kalkulo 	 business 
 compter 	 kalkuli 	 verb 
 comédien 	 aktoro 	 profession 
 concert 	 koncerto 	 art 
 concevoir 	 plani 	 verb 
 concurrence 	 konkurado 	 society 
 concurrence 	 konkurenco 	 business 
 concurrent 	 konkuranto 	 business 
 condition 	 kondiĉo 	 abstract 
 conduire 	 konduki 	 verb 
 conduire 	 stiri 	 verb 
 conduite 	 konduto 	 abstract 
 confrontation 	 komparo 	 abstract 
 congé 	 forpermeso 	 society 
 connaissance 	 kognicio 	 education 
 conscient 	 konscia 	 adjective 
 conseil 	 komisiono 	 society 
 conseil 	 koncilio 	 society 
 conseil 	 konsilo 	 communication 
 considérer 	 konsideri 	 verb 
 construction 	 konstruado 	 house 
 conséquence 	 konsekvenco 	 medicine 
 contenir 	 limigi 	 verb 
 continuer 	 dauxrigi 	 verb 
 contraire 	 malo 	 abstract 
 contrat 	 kontrakto 	 business 
 contre 	 al 	 preposition 
 contre 	 kontraux 	 preposition 
 contribution 	 impostigo 	 business 
 contrôler 	 komandi 	 verb 
 copain 	 amiko 	 family 
 copeau 	 peco 	 object 
 copie 	 kopio 	 object 
 copier 	 kopii 	 verb 
 copine 	 koramikino 	 family 
 corde 	 ŝnuro 	 transport 
 correct 	 gxusta 	 adjective 
 costume 	 vestoj 	 clothes 
 coton 	 kotono 	 material 
 cou 	 kolo 	 anatomy 
 coudre 	 kudri 	 verb 
 couleur 	 koloroj 	 art 
 coup 	 bato 	 abstract 
 coup 	 frapo 	 abstract 
 coup de pied 	 kiki 	 verb 
 coup de pied 	 piedbato 	 abstract 
 coupe 	 pokalo 	 object 
 coupe 	 taso 	 food 
 couper 	 trancxi 	 verb 
 couple 	 paro 	 number 
 courant 	 fluo 	 nature 
 courant 	 fluo 	 nature 
 courant 	 fluo 	 nature 
 courbure 	 kurbo 	 mathematics 
 courir 	 kuri 	 verb 
 cours 	 kurso 	 education 
 court 	 kurta 	 adjective 
 couteau 	 tranĉilo 	 food 
 couvercle 	 kovrilo 	 object 
 craindre 	 timi 	 verb 
 cravate 	 kravato 	 clothes 
 crayon 	 krajono 	 object 
 crevé 	 morta 	 adjective 
 cri 	 voko 	 communication 
 critère 	 kriterio 	 communication 
 croire 	 kredi 	 verb 
 croître 	 kreski 	 verb 
 cuiller 	 kulero 	 food 
 cuir 	 ledo 	 material 
 cuisine 	 kuirejo 	 house 
 cuisiner 	 kuiradi 	 verb 
 cuisiner 	 kuiri 	 verb 
 cuisinier 	 kuiristo 	 profession 
 culture 	 kulturo 	 society 
 côté 	 latero 	 mathematics 
 danger 	 danĝero 	 abstract 
 dangereux 	 danĝera 	 adjective 
 dans 	 en 	 adverb 
 dans 	 en 	 preposition 
 danser 	 danci 	 verb 
 date 	 dato 	 time 
 de 	 de 	 preposition 
 de qui 	 kies 	 pronoun 
 degré 	 grado 	 linguistics 
 dehors 	 ekster 	 adverb 
 demain 	 morgaŭ 	 adverb 
 demande 	 peto 	 communication 
 demander 	 peti 	 verb 
 dense 	 viskoza 	 adjective 
 dent 	 dento 	 anatomy 
 depuis 	 ekde 	 preposition 
 dernier 	 lasta 	 adjective 
 derrière 	 malantaux 	 adverb 
 dessiner 	 desegni 	 verb 
 dessus 	 super 	 adverb 
 destination 	 celo 	 abstract 
 destruction 	 detruo 	 abstract 
 deuxième 	 dua 	 adjective 
 devant 	 antaux 	 adverb 
 devenir 	 iĝi 	 verb 
 devoir 	 devo 	 abstract 
 dictionnaire 	 vortaro 	 linguistics 
 difficulté 	 malfacileco 	 abstract 
 différence 	 diferenco 	 abstract 
 différent 	 diferenca 	 adjective 
 dimanche 	 dimancxo 	 time 
 dire 	 diri 	 verb 
 directement 	 rekte 	 adverb 
 directeur 	 direktoro 	 profession 
 direction 	 direkto 	 mathematics 
 direction 	 kondukado 	 society 
 discipline 	 disciplino 	 linguistics 
 discussion 	 disputo 	 mathematics 
 discuter 	 diskuti 	 verb 
 disponible 	 havebla 	 adjective 
 distance 	 distanco 	 mathematics 
 divers 	 diversa 	 adjective 
 diversité 	 diverseco 	 art 
 divertissement 	 distraĵo 	 art 
 diviser 	 fendi 	 verb 
 dix 	 dek 	 number 
 docteur 	 doktoro 	 profession 
 doigt 	 fingro 	 anatomy 
 donc 	 do 	 adverb 
 donner 	 doni 	 verb 
 données 	 datumoj 	 communication 
 dos 	 dorso 	 anatomy 
 douceur 	 dolĉeco 	 food 
 douche 	 duŝo 	 house 
 douleur 	 doloro 	 medicine 
 doute 	 dubo 	 communication 
 douter 	 dubi 	 verb 
 doux 	 mola 	 adjective 
 douzième 	 dekdua 	 number 
 drapeau 	 flago 	 object 
 droit 	 dekstra 	 adjective 
 droit 	 juro 	 society 
 droit 	 rekta 	 adjective 
 dur 	 malfacila 	 adjective 
 d'abord 	 unue 	 adverb 
 d'or 	 ora 	 color 
 début 	 komenco 	 abstract 
 débuter 	 komenciĝi 	 verb 
 décembre 	 decembro 	 time 
 déchets 	 rubo 	 material 
 décider 	 decidi 	 verb 
 décision 	 decido 	 communication 
 déclaration 	 aserto 	 communication 
 décrire 	 priskribi 	 verb 
 défense 	 defendo 	 abstract 
 définitif 	 fina 	 adjective 
 dégager 	 liberigi 	 verb 
 déjeuner 	 matenmangxo 	 food 
 déjeuner 	 tagmanĝo 	 food 
 déjà 	 jam 	 adverb 
 délicat 	 delikata 	 adjective 
 délit 	 krimo 	 society 
 département 	 sekcio 	 society 
 dépasser 	 superi 	 verb 
 dépôt 	 garaĝo 	 transport 
 dérapage 	 glito 	 abstract 
 désirer 	 deziri 	 verb 
 détail 	 detalo 	 logistics 
 déterminé 	 fiksita 	 adjective 
 développer 	 evolucii 	 verb 
 eau 	 akvo 	 material 
 elle 	 ŝi 	 pronoun 
 embaumer 	 odori 	 verb 
 emplir 	 plenigi 	 verb 
 employé 	 laboristo 	 profession 
 empoisonner 	 veneni 	 verb 
 empêcher 	 preventi 	 verb 
 en réalité 	 vere 	 adverb 
 encore 	 ankoraux 	 adverb 
 encore 	 ree 	 adverb 
 encre 	 inko 	 material 
 endommager 	 difekti 	 verb 
 endurer 	 suferi 	 verb 
 enfant 	 infano 	 family 
 ennuyeux 	 teda 	 adjective 
 enregistrer 	 registri 	 verb 
 enrouler 	 bobeni 	 verb 
 enseignement 	 instruado 	 education 
 enseigner 	 instrui 	 verb 
 ensemble 	 kune 	 adverb 
 ensuite 	 poste 	 adverb 
 entendre 	 auxdi 	 verb 
 entendre 	 intenci 	 verb 
 entier 	 tuta 	 adjective 
 entraînement 	 trejnado 	 abstract 
 entre 	 inter 	 preposition 
 entrer 	 eniri 	 verb 
 entrée 	 antauxcxambro 	 house 
 enveloppe 	 koverto 	 object 
 envelopper 	 envolvi 	 verb 
 environ 	 proksimume 	 adverb 
 erreur 	 eraro 	 communication 
 escarpé 	 abrupta 	 adjective 
 espace 	 kosmo 	 mathematics 
 esprit 	 menso 	 mathematics 
 espèce 	 speco 	 abstract 
 espérer 	 esperi 	 verb 
 essai 	 peno 	 abstract 
 essayer 	 provi 	 verb 
 essayer 	 testi 	 verb 
 essence 	 esenco 	 abstract 
 essuyer 	 sekigi 	 verb 
 est 	 oriento 	 logistics 
 estimer 	 taksi 	 verb 
 estomac 	 stomako 	 anatomy 
 et 	 kaj 	 conjunction 
 exactement 	 gxuste 	 adverb 
 examen 	 ekzameno 	 communication 
 excellent 	 bonega 	 adjective 
 exemple 	 ekzemplo 	 communication 
 exercer 	 ekzerci 	 verb 
 existence 	 ekzistado 	 society 
 exister 	 ekzisti 	 verb 
 expert 	 lerta 	 adjective 
 expert 	 spertulo 	 profession 
 expliquer 	 ekspliki 	 verb 
 expérience 	 sperto 	 society 
 extérieur 	 eksterajxo 	 mathematics 
 facile 	 facila 	 adjective 
 facture 	 fakturo 	 business 
 facultatif 	 ajna 	 adjective 
 faculté 	 povo 	 abstract 
 faire 	 fari 	 verb 
 fait 	 fakto 	 abstract 
 famille 	 familio 	 family 
 famille 	 familio 	 family 
 fatigué 	 laca 	 adjective 
 faux 	 erara 	 adjective 
 faux 	 falsa 	 adjective 
 femme 	 edzino 	 family 
 femme 	 virino 	 family 
 femme 	 virino 	 society 
 fenêtre 	 fenestro 	 house 
 fer 	 fero 	 material 
 ferme 	 farmbieno 	 nature 
 ferme 	 firma 	 adjective 
 fermer 	 sxlosi 	 verb 
 fermé 	 fermita 	 adjective 
 feuille 	 folio 	 nature 
 fil 	 drato 	 object 
 filet 	 reto 	 material 
 fille 	 filino 	 family 
 fils 	 filo 	 family 
 fin 	 fino 	 abstract 
 financier 	 financa 	 adjective 
 fissure 	 fendeto 	 abstract 
 flamme 	 flamo 	 nature 
 fleur 	 floro 	 nature 
 fleuve 	 rivero 	 nature 
 foi 	 fido 	 society 
 fonction 	 funkcio 	 linguistics 
 fonction 	 funkcio 	 mathematics 
 fonctionnaire 	 oficisto 	 profession 
 fonctionnement 	 funkciado 	 mathematics 
 foncé 	 tenebra 	 adjective 
 fondamental 	 baza 	 adjective 
 football 	 piedpilko 	 sports 
 force 	 forto 	 abstract 
 force 	 forto 	 abstract 
 forme 	 formo 	 art 
 former 	 trejni 	 verb 
 formuler 	 esprimi 	 verb 
 fort 	 lauxta 	 adjective 
 forêt 	 arbaro 	 nature 
 fouet 	 vipo 	 object 
 four 	 kuirforno 	 device 
 fourchette 	 forko 	 food 
 fourmi 	 formiko 	 animal 
 fournir 	 liveri 	 verb 
 foyer 	 hejmo 	 house 
 fragile 	 fragila 	 adjective 
 frais 	 fresxa 	 adjective 
 frais 	 kosto 	 society 
 froid 	 malvarma 	 adjective 
 froid 	 malvarmo 	 nature 
 fromage 	 fromaĝo 	 food 
 front 	 frunto 	 anatomy 
 fructueux 	 sukcesa 	 adjective 
 fruit 	 frukto 	 food 
 fruit sec 	 nukso 	 food 
 frère 	 frato 	 family 
 fumer 	 fumi 	 verb 
 fumée 	 fumo 	 nature 
 fusil 	 pafilo 	 object 
 futur 	 estonteco 	 time 
 futur 	 venonta 	 adjective 
 féminin 	 ina 	 adjective 
 février 	 februaro 	 time 
 gagner 	 gajni 	 verb 
 gain 	 profito 	 business 
 garçon 	 knabo 	 family 
 gauche 	 lefta 	 adjective 
 genou 	 genuo 	 anatomy 
 gentil 	 afabla 	 adjective 
 gentil 	 beleta 	 adjective 
 glace 	 glacio 	 material 
 glace 	 glacio 	 nature 
 glapir 	 kriegi 	 verb 
 golf 	 golfo 	 travelling 
 gorge 	 gorgxo 	 anatomy 
 goutte 	 guto 	 object 
 gouvernement 	 regado 	 society 
 gouverner 	 regi 	 verb 
 goût 	 gusto 	 nature 
 goût 	 gustumi 	 verb 
 graine 	 spermo 	 food 
 grand 	 alta 	 adjective 
 grand 	 granda 	 adjective 
 grand 	 granda 	 adjective 
 gras 	 graso 	 material 
 gratuit 	 senpaga 	 adjective 
 grave 	 serioza 	 adjective 
 gris 	 grizo 	 adjective 
 gris 	 grizo 	 color 
 gros 	 dika 	 adjective 
 gros 	 grasa 	 adjective 
 grossier 	 kruda 	 adjective 
 groupe 	 grupo 	 abstract 
 guitare 	 gitaro 	 object 
 gâteau 	 kuko 	 food 
 gène 	 geno 	 anatomy 
 général 	 generalo 	 profession 
 général 	 gxenerala 	 adjective 
 généralement 	 ĝenerale 	 adverb 
 habile 	 inteligenta 	 adjective 
 habituel 	 regula 	 adjective 
 haine 	 malamo 	 relations 
 haut 	 supren 	 adverb 
 hauteur 	 alteco 	 abstract 
 herbe 	 herbo 	 nature 
 heure 	 horo 	 time 
 heureux 	 feliĉa 	 adjective 
 histoire 	 historio 	 society 
 hiver 	 vintro 	 nature 
 homme 	 homo 	 family 
 homme 	 homo 	 family 
 honorer 	 honori 	 verb 
 horloge 	 horlogxo 	 device 
 huile 	 oleo 	 material 
 huit 	 ok 	 number 
 huitieme 	 oka 	 number 
 humain 	 homa 	 adjective 
 humidité 	 humideco 	 nature 
 humour 	 humoro 	 communication 
 hôpital 	 malsanulejo 	 city 
 hôte 	 gasto 	 travelling 
 hôtel 	 hotelo 	 city 
 identifier 	 identigi 	 verb 
 ils 	 ili 	 pronoun 
 image 	 bildo 	 art 
 image 	 bildo 	 art 
 imiter 	 imiti 	 verb 
 immeuble 	 domo 	 city 
 immédiatement 	 momente 	 adverb 
 important 	 grava 	 adjective 
 important 	 signifoplena 	 adjective 
 imprimer 	 presi 	 verb 
 indigent 	 malricxa 	 adjective 
 indiquer 	 indiki 	 verb 
 individu 	 individuo 	 society 
 individuel 	 individua 	 adjective 
 industrie 	 industrio 	 society 
 industriel 	 industria 	 adjective 
 infirmière 	 flegistino 	 profession 
 information 	 informo 	 communication 
 insecte 	 insekto 	 animal 
 instant 	 momento 	 mathematics 
 institution 	 institucio 	 society 
 instrument 	 instrumento 	 device 
 intensifier 	 levi 	 verb 
 international 	 internacia 	 adjective 
 internet 	 interreto 	 mathematics 
 interview 	 intervjuo 	 communication 
 intituler 	 titoli 	 verb 
 intéressant 	 interesa 	 adjective 
 intérêt 	 intereso 	 communication 
 intérêt 	 interezo 	 business 
 investigation 	 esplorado 	 abstract 
 jambe 	 kruro 	 anatomy 
 janvier 	 januaro 	 time 
 jardin 	 ĝardeno 	 house 
 jaune 	 flava 	 color 
 jeter 	 jxeti 	 verb 
 jeu 	 ludo 	 mathematics 
 jeu 	 ludo 	 sports 
 jeudi 	 jxauxdo 	 time 
 jeune 	 juna 	 adjective 
 joindre 	 kunligi 	 verb 
 jouer 	 ludi 	 verb 
 joueur 	 ludanto 	 sports 
 journal 	 ĵurnalo 	 object 
 journaliste 	 ĵurnalisto 	 profession 
 journée 	 tago 	 nature 
 juge 	 juĝisto 	 profession 
 juillet 	 julio 	 time 
 juin 	 junio 	 time 
 jupe 	 jupo 	 clothes 
 jusqu'à 	 gxis 	 conjunction 
 la 	 la 	 article 
 labourer 	 plugi 	 verb 
 lac 	 lago 	 nature 
 laid 	 malbela 	 adjective 
 laine 	 lano 	 material 
 laisser 	 foriri 	 verb 
 laisser 	 permesi 	 verb 
 lait 	 lakto 	 food 
 lancer 	 ĵeto 	 sports 
 langage 	 lingvo 	 communication 
 langue 	 lango 	 anatomy 
 langue 	 natura lingvo 	 linguistics 
 langue 	 parolado 	 linguistics 
 large 	 largxa 	 adjective 
 laver 	 lavi 	 verb 
 le 	 li 	 pronoun 
 le long de 	 laux 	 adverb 
 lent 	 lanta 	 adjective 
 lentement 	 lante 	 adverb 
 les 	 ilin 	 pronoun 
 lettre 	 litero 	 linguistics 
 lettre 	 litero 	 object 
 leur 	 ilia 	 pronoun 
 lever 	 levi 	 verb 
 libre 	 libera 	 adjective 
 licencier 	 maldungi 	 verb 
 lieu 	 loko 	 abstract 
 ligne 	 streko 	 mathematics 
 limite 	 limito 	 mathematics 
 lion 	 leono 	 animal 
 liquide 	 likva 	 adjective 
 liquide 	 likva 	 nature 
 lire 	 legi 	 verb 
 lissé 	 glata 	 adjective 
 liste 	 listo 	 abstract 
 lit 	 lito 	 house 
 livre 	 libro 	 object 
 local 	 loka 	 adjective 
 loi 	 leĝo 	 society 
 loin 	 fora 	 adjective 
 long 	 longa 	 adjective 
 lourd 	 peza 	 adjective 
 lui 	 li 	 pronoun 
 lumière 	 lumo 	 nature 
 lundi 	 lundo 	 time 
 lune 	 luno 	 nature 
 lutte 	 batalado 	 abstract 
 lutter 	 batali 	 verb 
 l'un et l'autre 	 ambaux 	 adjective 
 là 	 tie 	 adverb 
 lèvre 	 lipo 	 anatomy 
 légal 	 leĝa 	 adjective 
 léger 	 malpeza 	 adjective 
 machine 	 aparato 	 device 
 mademoiselle 	 frauxlino 	 family 
 maigre 	 maldika 	 adjective 
 maigre 	 malgrasa 	 adjective 
 main 	 mano 	 anatomy 
 maintenant 	 nun 	 time 
 maison 	 domo 	 house 
 maison 	 domo 	 house 
 maison 	 firmo 	 business 
 majeur 	 majxora 	 adjective 
 majeur 	 ĉefa 	 adjective 
 majorité 	 plejparto 	 abstract 
 majuscule 	 majusklo 	 linguistics 
 mal 	 malgxusta 	 adjective 
 malade 	 malsana 	 adjective 
 maladie 	 malsano 	 medicine 
 maman 	 patrino 	 family 
 manger 	 manĝi 	 verb 
 manifestement 	 evidente 	 adverb 
 manière 	 maniero 	 mathematics 
 manquer 	 neglekti 	 verb 
 manteau 	 palto 	 clothes 
 marche 	 sxtupo 	 house 
 marcher 	 marsxi 	 verb 
 marché 	 bazaro 	 business 
 mari 	 edzo 	 family 
 mariage 	 edzeco 	 society 
 mariage 	 geedzigxo 	 family 
 mariage 	 nupto 	 family 
 marin 	 maristo 	 profession 
 marié 	 edzinigxinta 	 adjective 
 marque 	 marko 	 abstract 
 marron 	 bruna 	 color 
 marteau 	 martelo 	 object 
 masse 	 maso 	 physics 
 massue 	 klabo 	 object 
 matin 	 mateno 	 time 
 matière 	 materio 	 material 
 matériau 	 materialo 	 material 
 matériel 	 materia 	 adjective 
 mauvais 	 malbona 	 adjective 
 maître 	 instruisto 	 profession 
 me 	 min 	 pronoun 
 membre 	 membro 	 society 
 mensonge 	 mensogo 	 communication 
 menstruation 	 monatajxo 	 medicine 
 mentir 	 mensogi 	 verb 
 menton 	 mentono 	 anatomy 
 menu 	 menuo 	 object 
 mer 	 maro 	 nature 
 mercredi 	 merkredo 	 time 
 mesurage 	 mezurado 	 art 
 mesure 	 mezuro 	 abstract 
 mesurer 	 mezuri 	 verb 
 mettre 	 porti 	 verb 
 milieu 	 centro 	 mathematics 
 milieu 	 medio 	 nature 
 milieu 	 meznombro 	 mathematics 
 militaire 	 militisto 	 adjective 
 militaire 	 soldato 	 profession 
 mille 	 mil 	 number 
 million 	 miliono 	 number 
 mine 	 minejo 	 object 
 ministre 	 ministro 	 profession 
 minuit 	 noktomezo 	 time 
 minuscule 	 eta 	 adjective 
 minute 	 minuto 	 time 
 miroir 	 spegulo 	 house 
 mise 	 kostumo 	 clothes 
 mobilier 	 mebloj 	 house 
 mode 	 modo 	 abstract 
 moderne 	 moderna 	 adjective 
 moderne 	 moderna 	 adjective 
 modeste 	 eta 	 adjective 
 modèle 	 desegno 	 object 
 mois 	 monato 	 time 
 mois 	 monato 	 transport 
 moitié 	 duono 	 mathematics 
 moment 	 minuto 	 time 
 mon 	 mia 	 pronoun 
 monde 	 mondo 	 nature 
 montagne 	 monto 	 nature 
 montant 	 sumo 	 mathematics 
 montre 	 horloĝo 	 object 
 montrer 	 montri 	 verb 
 morceau 	 peco 	 abstract 
 morceau 	 peco 	 object 
 mordre 	 mordi 	 verb 
 mort 	 morto 	 nature 
 mot 	 vorto 	 linguistics 
 moteur 	 motoro 	 device 
 mouche 	 muŝo 	 animal 
 mouiller 	 malsekigi 	 verb 
 mouillé 	 malseka 	 adjective 
 mourir 	 morti 	 verb 
 mouton 	 ŝafo 	 animal 
 mouvement 	 movado 	 physics 
 mouvement 	 movo 	 physics 
 mur 	 muro 	 house 
 muscle 	 muskolo 	 anatomy 
 musicien 	 muzikisto 	 profession 
 musique 	 muziko 	 art 
 musée 	 muzeo 	 city 
 mâle 	 maskla 	 adjective 
 mâle 	 masklo 	 society 
 médical 	 medicina 	 adjective 
 mémoire 	 memoro 	 communication 
 mémoire 	 memoro 	 communication 
 mépriser 	 malami 	 verb 
 métal 	 metalo 	 material 
 métallique 	 metala 	 adjective 
 méthode 	 metodo 	 mathematics 
 méthode 	 procedo 	 mathematics 
 métro 	 metroo 	 transport 
 même 	 sama 	 adjective 
 nation 	 nacio 	 society 
 national 	 nacia 	 adjective 
 nature 	 naturo 	 nature 
 naturel 	 natura 	 adjective 
 navire 	 ŝipo 	 transport 
 neige 	 negxo 	 nature 
 neige 	 neĝo 	 nature 
 neiger 	 negxi 	 verb 
 nerf 	 nervo 	 anatomy 
 neuf 	 naŭ 	 number 
 neuf 	 nova 	 adjective 
 neuvième 	 naŭa 	 number 
 nez 	 nazo 	 anatomy 
 niveau 	 grado 	 linguistics 
 noeud 	 nodo 	 object 
 noir 	 nigra 	 adjective 
 nom 	 nomo 	 linguistics 
 nombre 	 nombro 	 linguistics 
 nommer 	 nomi 	 verb 
 non 	 ne 	 abstract 
 non 	 ne 	 adverb 
 nonobstant 	 malgraŭ 	 preposition 
 nord 	 norda 	 adjective 
 nord 	 nordo 	 logistics 
 normal 	 normala 	 adjective 
 normal 	 normala 	 adjective 
 normalement 	 kutime 	 adverb 
 note 	 noto 	 communication 
 note 	 noto 	 education 
 note 	 tononomo 	 art 
 nourriture 	 nutraĵo 	 food 
 nous 	 ni 	 pronoun 
 nous 	 nia 	 pronoun 
 nous 	 nin 	 pronoun 
 nouvelles 	 novaĵo 	 society 
 novembre 	 novembro 	 time 
 nuage 	 nubo 	 nature 
 nuit 	 nokto 	 nature 
 nécessaire 	 necesa 	 adjective 
 négociant 	 negocisto 	 profession 
 objection 	 protesto 	 communication 
 obtenir 	 akiri 	 verb 
 occasion 	 okazo 	 abstract 
 occupation 	 aĵo 	 abstract 
 occupation 	 okupo 	 business 
 octobre 	 oktobro 	 time 
 odeur 	 odoro 	 nature 
 oeil 	 okulo 	 anatomy 
 oeuf 	 ovo 	 food 
 oeuvre 	 laboro 	 abstract 
 offre 	 oferto 	 abstract 
 offrir 	 oferti 	 verb 
 oiseau 	 birdo 	 animal 
 ongle 	 ungo 	 anatomy 
 opposé 	 kontrauxa 	 adjective 
 opération 	 operacio 	 abstract 
 or 	 oro 	 material 
 orange 	 orangxa 	 color 
 orange 	 oranĝo 	 food 
 orchestre 	 orkestro 	 art 
 ordinateur 	 komputero 	 device 
 ordonner 	 ordoni 	 verb 
 ordre 	 mendo 	 society 
 ordre 	 ordeno 	 society 
 ordre 	 ordo 	 linguistics 
 oreille 	 anso 	 object 
 oreille 	 orelo 	 anatomy 
 organisation 	 organizado 	 society 
 organiser 	 plani 	 verb 
 original 	 origina 	 adjective 
 original 	 originalo 	 object 
 ornement 	 dekoro 	 object 
 orteil 	 piedfingro 	 anatomy 
 orthographe 	 ortografio 	 linguistics 
 os 	 osto 	 anatomy 
 ou 	 aŭ 	 conjunction 
 oublier 	 forgesi 	 verb 
 ouest 	 okcidento 	 logistics 
 oui 	 jes 	 abstract 
 ours 	 urso 	 animal 
 ouvrir 	 malfermi 	 verb 
 page 	 paĝo 	 object 
 pain 	 pano 	 food 
 pair 	 para 	 adjective 
 paix 	 paco 	 abstract 
 panier 	 korbo 	 object 
 papa 	 patro 	 family 
 papier 	 papero 	 material 
 paquet 	 pako 	 object 
 parallèle 	 paralela 	 adjective 
 paraître 	 aspekti 	 verb 
 parc 	 parko 	 city 
 pardonner 	 pardoni 	 verb 
 parfois 	 fojfoje 	 adverb 
 parler 	 paroli 	 verb 
 partage 	 divido 	 mathematics 
 particulièrement 	 speciale 	 adverb 
 partie 	 festo 	 society 
 partie 	 matcxo 	 sports 
 partie 	 parto 	 abstract 
 partie 	 parto 	 society 
 pas 	 pasxo 	 mathematics 
 passager 	 pasagxero 	 transport 
 passeport 	 pasporto 	 object 
 passion 	 amo 	 relations 
 passé 	 pasinta 	 adjective 
 patient 	 pacienca 	 adjective 
 patient 	 paciento 	 medicine 
 patron 	 modelo 	 object 
 pause 	 paŭzo 	 time 
 pauvre 	 malriĉa 	 adjective 
 payer 	 pagi 	 verb 
 pays 	 ruro 	 society 
 peau 	 hauxto 	 anatomy 
 peine 	 peno 	 abstract 
 peinture 	 farbo 	 art 
 peler 	 elŝeligi 	 verb 
 pellicule 	 filmo 	 art 
 pendant 	 dum 	 preposition 
 pensée 	 penso 	 communication 
 pente 	 deklivo 	 mathematics 
 perdre 	 perdi 	 verb 
 perdre 	 perdi 	 verb 
 permettre 	 permesi 	 verb 
 personne 	 persono 	 family 
 personnel 	 bastono 	 society 
 personnel 	 persona 	 adjective 
 perte 	 perdo 	 business 
 peser 	 pezi 	 verb 
 petit 	 bagatela 	 adjective 
 petit 	 malgranda 	 adjective 
 peu 	 malmulta 	 adjective 
 peu 	 malmulta 	 adverb 
 peuple 	 popolamaso 	 society 
 peur 	 timo 	 relations 
 peut-être 	 eble 	 adverb 
 photographe 	 fotografisto 	 profession 
 phrase 	 frazo 	 linguistics 
 physique 	 fizika 	 adjective 
 physique 	 fizika 	 adjective 
 pied 	 piedo 	 anatomy 
 pilote 	 piloto 	 profession 
 pièce 	 ĉambro 	 house 
 placard 	 sxranko 	 house 
 plage 	 strando 	 nature 
 plaider 	 argumenti 	 verb 
 plaine 	 ebenejo 	 nature 
 plaisir 	 plezuro 	 abstract 
 plan 	 plano 	 abstract 
 plan 	 plata 	 adjective 
 plante 	 planto 	 house 
 plein 	 plena 	 adjective 
 pleurer 	 plori 	 verb 
 pleuvoir 	 pluvi 	 verb 
 pli 	 falto 	 object 
 plomb 	 plumbo 	 material 
 pluie 	 pluvo 	 nature 
 pluie 	 pluvo 	 nature 
 plume 	 plumo 	 object 
 plume 	 plumo 	 object 
 plus 	 pli 	 adjective 
 plus 	 plue 	 adjective 
 plutôt 	 prefere 	 adverb 
 poche 	 saketo 	 object 
 poids 	 pezo 	 physics 
 point 	 punkto 	 linguistics 
 point 	 suturero 	 medicine 
 poisson 	 fiŝo 	 animal 
 poitrine 	 brusto 	 anatomy 
 poitrine 	 brusto 	 anatomy 
 police 	 polico 	 society 
 policier 	 policano 	 profession 
 polir 	 purigi 	 verb 
 politicien 	 politikisto 	 profession 
 politique 	 politika 	 adjective 
 politique 	 politiko 	 society 
 pomme 	 pomo 	 food 
 pomme de terre 	 terpomo 	 food 
 pompe 	 pumpilo 	 device 
 pomper 	 pumpi 	 verb 
 pondre 	 meti 	 verb 
 pont 	 ponto 	 object 
 population 	 logxantaro 	 society 
 porc 	 porko 	 animal 
 port 	 afranko 	 object 
 porte 	 pordo 	 house 
 porter 	 porti 	 verb 
 porter 	 porti 	 verb 
 poser 	 sidi 	 verb 
 possesseur 	 posedanto 	 business 
 possible 	 eventuala 	 adjective 
 possible 	 versxajna 	 adjective 
 poste 	 pozicio 	 linguistics 
 poste 	 poŝto 	 communication 
 poste 	 stacio 	 society 
 poster 	 sendi 	 verb 
 pouce 	 dikfingro 	 anatomy 
 pourcentage 	 elcento 	 mathematics 
 pourquoi 	 kial 	 adverb 
 pousser 	 emigi 	 verb 
 pousser 	 puŝi 	 verb 
 poussière 	 polvo 	 material 
 poussière 	 polvo 	 material 
 poème 	 poemo 	 art 
 poésie 	 poezio 	 art 
 premier 	 antauxa 	 adjective 
 prendre 	 kapti 	 verb 
 presque 	 preskaux 	 adverb 
 pression 	 premo 	 nature 
 printemps 	 printempo 	 nature 
 prison 	 prizono 	 city 
 privé 	 privata 	 adjective 
 prix 	 depago 	 business 
 prix 	 kosto 	 business 
 prix 	 prezo 	 transport 
 problème 	 problemo 	 abstract 
 problème 	 problemo 	 mathematics 
 proche 	 proksima 	 adjective 
 procéder 	 konduti 	 verb 
 production 	 produktado 	 abstract 
 produire 	 fabriki 	 verb 
 produit 	 produkto 	 object 
 professionnel 	 profesia 	 adjective 
 professionnel 	 profesiisto 	 profession 
 profit 	 profiti 	 verb 
 profit 	 utilo 	 abstract 
 programme 	 programo 	 abstract 
 promulguer 	 publikigi 	 verb 
 prononciation 	 prononco 	 linguistics 
 proposition 	 propono 	 abstract 
 proposition 	 propono 	 abstract 
 propre 	 propra 	 adjective 
 propre 	 pura 	 adjective 
 propriété 	 havo 	 society 
 protester 	 protesti 	 verb 
 prototype 	 prototipo 	 linguistics 
 prouver 	 montri 	 verb 
 prématuré 	 frue 	 adjective 
 préparer 	 pretigi 	 verb 
 présent 	 donaco 	 object 
 présent 	 nuna 	 adjective 
 présenter 	 prezenti 	 verb 
 présenter 	 prezenti 	 verb 
 président 	 prezidento 	 profession 
 prêt 	 preta 	 adjective 
 public 	 publika 	 travelling 
 puits 	 puto 	 object 
 période 	 epoko 	 time 
 pétrole 	 petrolo 	 material 
 qualité 	 kvalito 	 abstract 
 quantité 	 nombro 	 abstract 
 quarante 	 kvardek 	 number 
 quatre 	 kvar 	 number 
 quatre-vingts 	 okdek 	 number 
 quatrième 	 kvara 	 number 
 que 	 kiu 	 pronoun 
 que 	 ol 	 conjunction 
 quel 	 kiu 	 pronoun 
 question 	 demando 	 linguistics 
 questionnaire 	 formularo 	 society 
 queue 	 vosto 	 anatomy 
 qui 	 kiu 	 pronoun 
 quoi 	 kio 	 pronoun 
 racine 	 radiko 	 mathematics 
 racine 	 radiko 	 nature 
 rail 	 relo 	 transport 
 raison 	 motivo 	 communication 
 raison 	 tero 	 communication 
 rapide 	 rapida 	 logistics 
 rapport 	 raporto 	 abstract 
 rayon 	 sekcio 	 mathematics 
 recevoir 	 ricevi 	 verb 
 recherche 	 esploro 	 abstract 
 record 	 rekordo 	 abstract 
 refuser 	 rifuzi 	 verb 
 regard 	 rigardo 	 communication 
 regarder 	 observi 	 verb 
 regarder 	 rigardi 	 verb 
 relation 	 rilato 	 communication 
 relever 	 kondimenti 	 verb 
 religion 	 religio 	 society 
 remercier 	 danki 	 verb 
 remettre 	 liveri 	 verb 
 rencontre 	 renkontigxo 	 communication 
 rencontrer 	 renkonti 	 verb 
 rendez-vous 	 rendevuo 	 relations 
 rendre 	 fari 	 verb 
 rendre 	 redoni 	 verb 
 repas 	 manĝo 	 food 
 repos 	 ripozo 	 abstract 
 reposer 	 kusxi 	 verb 
 représentant 	 reprezentanto 	 profession 
 représenter 	 reprezenti 	 verb 
 responsabilité 	 respondeco 	 abstract 
 responsable 	 respondeca 	 adjective 
 ressort 	 risorto 	 object 
 restaurant 	 restoracio 	 city 
 reste 	 resto 	 business 
 rester 	 resti 	 verb 
 revenu 	 enspezo 	 business 
 revue 	 revuo 	 object 
 rhume 	 malvarmumo 	 medicine 
 rideau 	 kurteno 	 house 
 rien 	 nenio 	 mathematics 
 rigide 	 nefleksebla 	 adjective 
 rire 	 ridi 	 verb 
 risquer 	 riski 	 verb 
 rive 	 bordo 	 nature 
 riz 	 rizo 	 food 
 riz 	 rizo 	 food 
 roi 	 regxo 	 society 
 rompre 	 rompi 	 verb 
 rond 	 cirkla 	 adjective 
 rose 	 rozkolora 	 color 
 roue 	 rado 	 object 
 rouge 	 rugxa 	 color 
 rouleau 	 bobeno 	 object 
 route 	 strato 	 city 
 royal 	 regxa 	 adjective 
 ruse 	 ruzo 	 abstract 
 rythme 	 ritmo 	 art 
 règlement 	 regulo 	 linguistics 
 réaction 	 reago 	 abstract 
 réaliser 	 atingi 	 verb 
 récemment 	 nelge 	 adverb 
 récent 	 fresxdata 	 adjective 
 récompense 	 rekompenco 	 society 
 récréation 	 pauxzo 	 abstract 
 réduire 	 plimalgrandigi 	 verb 
 réellement 	 vere 	 adverb 
 réfléchir 	 opinii 	 verb 
 réfléchir 	 reflekti 	 verb 
 région 	 regiono 	 nature 
 répondre 	 respondi 	 verb 
 réponse 	 respondo 	 communication 
 république 	 respubliko 	 society 
 résultat 	 rezulto 	 mathematics 
 rétention 	 enhavi 	 verb 
 révéler 	 riveli 	 verb 
 sa 	 gxia 	 pronoun 
 sa 	 lia 	 pronoun 
 sable 	 sablo 	 material 
 sac 	 mansaketo 	 clothes 
 sage 	 sagxa 	 adjective 
 saisir 	 kompreni 	 verb 
 saisir 	 preni 	 verb 
 saison 	 sezono 	 nature 
 salade 	 salato 	 food 
 sale 	 malpura 	 adjective 
 sale 	 malpura 	 adjective 
 saler 	 sali 	 verb 
 salle de bains 	 bancxambro 	 house 
 salubre 	 salubra 	 adjective 
 salve 	 eksplodo 	 abstract 
 samedi 	 sabato 	 time 
 sandwich 	 sandvicxo 	 food 
 sang 	 sango 	 anatomy 
 santé 	 sano 	 abstract 
 santé 	 sano 	 medicine 
 sauce 	 sauxco 	 food 
 saut 	 salto 	 abstract 
 sauter 	 salti 	 verb 
 savoir 	 scii 	 verb 
 savon 	 sapo 	 material 
 savonner 	 sapi 	 verb 
 science 	 scienco 	 society 
 scientifique 	 scienculo 	 profession 
 scène 	 scenejo 	 object 
 se disputer 	 disputi 	 verb 
 se reposer 	 ripozi 	 verb 
 sec 	 seka 	 adjective 
 seconde 	 sekundo 	 time 
 secret 	 sekreta 	 communication 
 secrétaire 	 sekretario 	 profession 
 secteur 	 divizio 	 mathematics 
 sel 	 salo 	 food 
 semaine 	 semajno 	 time 
 semblable 	 simila 	 adjective 
 sentiment 	 sento 	 communication 
 sentinelle 	 gardo 	 profession 
 sentir 	 fetori 	 verb 
 sentir 	 odori 	 verb 
 sentir 	 palpi 	 verb 
 sept 	 sep 	 number 
 septième 	 sepa 	 number 
 serpent 	 serpento 	 animal 
 serrure 	 seruro 	 house 
 serré 	 strikta 	 adjective 
 service 	 servado 	 sports 
 seul 	 sola 	 adjective 
 seul 	 sole 	 adverb 
 seulement 	 nur 	 adverb 
 sexe 	 sekso 	 nature 
 sexe 	 sekso 	 relations 
 si 	 cxu 	 conjunction 
 si 	 se 	 conjunction 
 signaler 	 riporti 	 verb 
 silence 	 kvieteco 	 abstract 
 simple 	 simpla 	 adjective 
 simple 	 unuopa 	 adjective 
 sincère 	 sincera 	 adjective 
 singe 	 simio 	 animal 
 sinistre 	 damagxo 	 transport 
 situation 	 situacio 	 abstract 
 six 	 ses 	 number 
 sixième 	 sesa 	 number 
 siècle 	 jarcento 	 time 
 social 	 sociala 	 adjective 
 société 	 socio 	 society 
 soeur 	 fratino 	 family 
 soie 	 silko 	 material 
 soir 	 vespero 	 time 
 soixante 	 sesdek 	 number 
 soixante-dix 	 sepdek 	 number 
 sol 	 planko 	 house 
 sol 	 tero 	 material 
 soleil 	 suno 	 nature 
 solitaire 	 sola 	 adjective 
 sommeil 	 dormado 	 nature 
 sommet 	 supro 	 abstract 
 son 	 sono 	 nature 
 son 	 sxia 	 pronoun 
 sorte 	 speco 	 abstract 
 sot 	 stulta 	 adjective 
 souci 	 flegado 	 abstract 
 soudain 	 subita 	 adjective 
 souhait 	 deziro 	 abstract 
 soulager 	 helpi 	 verb 
 soupe 	 supo 	 food 
 source 	 fonto 	 nature 
 source 	 origino 	 transport 
 sourire 	 rideti 	 verb 
 sourire 	 rideto 	 abstract 
 soutenir 	 subteni 	 verb 
 souvent 	 ofte 	 adverb 
 spécial 	 speciala 	 adjective 
 spécifique 	 specifa 	 adjective 
 structure 	 strukturo 	 linguistics 
 stupide 	 stulta 	 adjective 
 style 	 stilo 	 art 
 subitement 	 subite 	 adverb 
 succès 	 sukceso 	 society 
 sucre 	 karbonhidrato 	 food 
 sucre 	 sukero 	 food 
 sucré 	 dolcxa 	 adjective 
 sud 	 sudo 	 logistics 
 suggérer 	 proponi 	 verb 
 suivant 	 venonta 	 adjective 
 suivre 	 sekvi 	 verb 
 sujet 	 subjekto 	 linguistics 
 supermarché 	 superbazaro 	 city 
 supposer 	 supozi 	 verb 
 supprimer 	 elpreni 	 verb 
 sur 	 post 	 adjective 
 surface 	 surfaco 	 mathematics 
 surprendre 	 surprizi 	 verb 
 surprise 	 surprizo 	 abstract 
 système 	 sistemo 	 linguistics 
 sécher 	 sekigi 	 verb 
 séparée 	 aparta 	 adjective 
 série 	 kompleto 	 mathematics 
 sérénité 	 sereneco 	 abstract 
 sûr 	 sekura 	 adjective 
 table 	 tabelo 	 object 
 table 	 tablo 	 house 
 tableau 	 pentrado 	 art 
 taille 	 grandeco 	 physics 
 tampon 	 stampilo 	 object 
 tapis 	 tapiŝo 	 house 
 tard 	 malfrue 	 adverb 
 technologie 	 inĝenierarto 	 abstract 
 technologie 	 teknologio 	 society 
 teinte 	 koloro 	 art 
 tel 	 tia 	 adverb 
 temps 	 tempo 	 physics 
 temps 	 vetero 	 nature 
 tendance 	 tendenco 	 abstract 
 tenir 	 konservi 	 verb 
 tenir 	 teni 	 verb 
 tennis 	 teniso 	 sports 
 terminer 	 fini 	 verb 
 terminer 	 fini 	 verb 
 terrain 	 kampo 	 nature 
 terre 	 grundo 	 material 
 terre 	 grundo 	 nature 
 tes 	 via 	 pronoun 
 testament 	 testamento 	 society 
 thé 	 teo 	 food 
 théorie 	 teorio 	 education 
 théâtre 	 teatro 	 city 
 tige 	 tigo 	 nature 
 tirer 	 pafi 	 verb 
 tirer 	 tiri 	 verb 
 tiroir 	 tirkesto 	 house 
 titre 	 titolo 	 society 
 toilettes 	 necesejo 	 house 
 toit 	 tegmento 	 house 
 tomate 	 tomato 	 food 
 tomber 	 fali 	 verb 
 touche 	 klavo 	 object 
 toucher 	 tusxo 	 abstract 
 toujours 	 ĉiam 	 adverb 
 tourner 	 turni 	 verb 
 tousser 	 tusi 	 verb 
 tout 	 cxio 	 adjective 
 tout 	 cxio 	 pronoun 
 tout 	 tutajxo 	 abstract 
 toux 	 tuso 	 medicine 
 train 	 trajno 	 transport 
 traitement 	 kuracado 	 abstract 
 traiter 	 prilabori 	 verb 
 traiter 	 trakti 	 verb 
 trajet 	 vojagxo 	 transport 
 tranquille 	 kvieta 	 adjective 
 transport 	 transporto 	 transport 
 transporter 	 transporti 	 verb 
 travail 	 laboro 	 abstract 
 travail 	 tasko 	 business 
 travailler 	 labori 	 verb 
 trente 	 tridek 	 number 
 triage 	 elekto 	 abstract 
 tribunal 	 tribunalo 	 society 
 triste 	 lamentinda 	 adjective 
 triste 	 malgaja 	 adjective 
 trois 	 tri 	 number 
 troisième 	 tria 	 mathematics 
 tronc 	 torso 	 anatomy 
 trou 	 truo 	 abstract 
 trouver 	 trovi 	 verb 
 trouver 	 trovi 	 verb 
 très 	 tre 	 adverb 
 tuyauterie 	 tubaro 	 object 
 tâche 	 tasko 	 abstract 
 téléphone cellulaire 	 poŝtelefono 	 device 
 téléphoner 	 alvoki 	 verb 
 tête 	 kapo 	 anatomy 
 tôt 	 frue 	 adverb 
 union 	 unuiĝo 	 society 
 unité 	 unito 	 mathematics 
 université 	 universitato 	 city 
 université 	 universitato 	 education 
 usage 	 uzo 	 linguistics 
 usine 	 fabriko 	 city 
 usine 	 fabriko 	 city 
 utilisateur 	 uzanto 	 society 
 utiliser 	 uzi 	 verb 
 vache 	 bovino 	 animal 
 vague 	 ondo 	 nature 
 vaincre 	 venki 	 verb 
 valeur 	 valoro 	 art 
 valise 	 valizo 	 clothes 
 vapeur 	 vaporo 	 physics 
 vendre 	 vendi 	 verb 
 vendredi 	 vendredo 	 time 
 venin 	 veneno 	 material 
 venir 	 veni 	 verb 
 vent 	 vento 	 nature 
 vente 	 vendo 	 business 
 verre 	 glaso 	 food 
 verre 	 vitro 	 material 
 vers 	 al 	 preposition 
 vert 	 verda 	 color 
 veste 	 jako 	 clothes 
 viande 	 viando 	 food 
 vie 	 vivo 	 nature 
 vieux 	 maljuna 	 adjective 
 vif 	 vivanta 	 adjective 
 village 	 vilagxo 	 society 
 village 	 vilaĝo 	 society 
 ville 	 metropolo 	 society 
 ville 	 urbo 	 society 
 vin 	 vino 	 food 
 vingt 	 dudek 	 number 
 violent 	 perforta 	 adjective 
 violet 	 violkolora 	 color 
 visage 	 vizaĝo 	 anatomy 
 visite 	 vizito 	 abstract 
 visiter 	 viziti 	 verb 
 vite 	 rapide 	 adverb 
 vivre 	 vivi 	 verb 
 voile 	 velo 	 object 
 voilure 	 klingo 	 object 
 voir 	 vidi 	 verb 
 voire 	 ecx 	 adverb 
 voisin 	 najbaro 	 family 
 voix 	 vocxo 	 communication 
 vol 	 flugo 	 transport 
 voler 	 flugi 	 verb 
 voler 	 sxteli 	 verb 
 volonté 	 volo 	 abstract 
 vouloir 	 voli 	 verb 
 vrai 	 efektiva 	 adjective 
 vrai 	 vera 	 adjective 
 vrai 	 verema 	 adjective 
 vraisemblablement 	 versxajne 	 adverb 
 weekend 	 semajnfino 	 time 
 zone 	 amplekso 	 abstract 
 États-Unis 	 Usono 	 country 
 à 	 ene 	 adverb 
 âge 	 aĝo 	 time 
 âge 	 epoko 	 time 
 ça 	 gxin 	 pronoun 
 écart 	 devio 	 mathematics 
 échange 	 substituo 	 abstract 
 école 	 lernejo 	 city 
 économe 	 ekonomia 	 adjective 
 économie 	 ekonomio 	 business 
 économique 	 ekonomia 	 adjective 
 économique 	 malmultekosta 	 adjective 
 écraser 	 dispremi 	 verb 
 écraser 	 pisti 	 verb 
 écrire 	 skribi 	 verb 
 écriture 	 skribo 	 linguistics 
 écrivain 	 verkisto 	 profession 
 écrou 	 boltingo 	 object 
 éducation 	 edukado 	 society 
 égal 	 ebena 	 adjective 
 égal 	 egala 	 adjective 
 égaliser 	 niveli 	 verb 
 église 	 eklezio 	 city 
 élection 	 elekto 	 mathematics 
 électrique 	 elektra 	 adjective 
 élever 	 eduki 	 verb 
 éliminer 	 mortigi 	 verb 
 élégant 	 eleganta 	 adjective 
 élément 	 elemento 	 mathematics 
 élément chimique 	 kemia elemento 	 material 
 éléphant 	 elefanto 	 animal 
 énergie 	 energio 	 nature 
 épais 	 dika 	 adjective 
 épargner 	 ŝpari 	 verb 
 épingle 	 pinglo 	 object 
 épouser 	 edzigxi 	 verb 
 éprouver 	 travivi 	 verb 
 équilibre 	 ekvilibro 	 physics 
 équipe 	 teamo 	 society 
 établir 	 fondi 	 verb 
 étage 	 etagxo 	 house 
 étape 	 fazo 	 time 
 état 	 stato 	 mathematics 
 état 	 ŝtato 	 society 
 état 	 ŝtato 	 society 
 étoffe 	 sxtofo 	 material 
 étoile 	 astro 	 nature 
 étranger 	 eksterlanda 	 adjective 
 étroit 	 malvasta 	 adjective 
 étudiant 	 lernanto 	 profession 
 étudier 	 lerni 	 verb 
 étudier 	 studi 	 verb 
 été 	 somero 	 nature 
 éveillé 	 maldorma 	 adjective 
 évier 	 lavkuvo 	 house 
 éviter 	 eviti 	 verb 
 évolution 	 evoluo 	 nature 
 événement 	 evento 	 abstract 
 événement 	 okazo 	 abstract 
 être debout 	 stari 	 verb 
 être d'accord 	 konsenti 	 verb 
 île 	 insulo 	 nature 
